butter, salted	unsalted butter
cheese, cheddar	cottage cheese
cream, fluid, half and half	half and half
cream, sour, cultured	cream cheese
milk, whole, 3.25% milkfat, with added vitamin d	whole milk
milk, reduced fat, fluid, 2% milkfat, with added vitamin a and vitamin d	whole milk
egg, whole, raw, fresh	whole brown egg
egg, yolk, raw, fresh	brown egg yolk
chicken, broiler or fryers, breast, skinless, boneless, meat only, raw	chicken breast
soup, chicken broth, ready-to-serve	low sodium chicken broth
soup, chicken broth, ready-to-serve, reduced sodium	low sodium chicken broth
soup, beef broth, ready-to-serve	vegetable broth
soup, vegetable broth, ready-to-serve	vegetable broth
soup, chicken noodle, ready-to-serve	low sodium chicken broth
soup, tomato, ready-to-serve	muir's diced tomatoes
chicken, broiler or fryers, thigh, skinless, boneless, meat only, raw	chicken breast
chicken, broiler or fryers, wing, meat and skin, raw	chicken breast
chicken, broiler or fryers, leg, meat and skin, raw	chicken breast
chicken, broiler or fryers, meat and skin, raw	chicken breast
chicken, broiler or fryers, giblets, raw	chicken breast
beef, ground, 85% lean meat / 15% fat, raw	lean ground beef
beef, ground, 80% lean meat / 20% fat, raw	lean ground beef
beef, ground, 90% lean meat / 10% fat, raw	lean ground beef
beef, ground, 95% lean meat / 5% fat, raw	lean ground beef
beef, round, top round, separable lean only, trimmed to 1/8" fat, choice, raw	lean ground beef
beef, chuck, shoulder clod, separable lean only, trimmed to 1/8" fat, choice, raw	lean ground beef
beef, loin, tenderloin, separable lean only, trimmed to 1/8" fat, choice, raw	lean ground beef
pork, fresh, loin, center loin (chops), bone-in, separable lean only, raw	lean ground beef
pork, fresh, loin, tenderloin, separable lean only, raw	lean ground beef
pork, fresh, shoulder, whole, separable lean only, raw	lean ground beef
fish, salmon, atlantic, farmed, raw	salmon
fish, salmon, chinook, raw	salmon
fish, tuna, light, canned in water, drained solids	canned tuna in water
fish, tuna, yellowfin, fresh, raw	canned tuna in water
fish, cod, atlantic, raw	salmon
fish, halibut, atlantic and pacific, raw	salmon
shellfish, shrimp, mixed species, raw	salmon
bread, white, commercially prepared (includes soft bread crumbs)	whole wheat bread
bread, whole-wheat, commercially prepared	whole wheat bread
bread, reduced-calorie, white	whole wheat bread
bread, reduced-calorie, wheat	whole wheat bread
cereals, oats, instant, fortified, plain, prepared with water (boiling water added or microwaved)	cooked oat bran
cereals, ready-to-eat, wheat, puffed, fortified	cooked oat bran
cereals, ready-to-eat, rice, puffed, fortified	cooked white rice
rice, white, long-grain, regular, raw, unenriched	cooked white rice
rice, brown, long-grain, raw	cooked white rice
pasta, cooked, unenriched, without added salt	cooked white rice
potatoes, russet, flesh and skin, raw	red potatoes with skin
potatoes, red, flesh and skin, raw	red potatoes with skin
sweet potato, raw, unprepared	red potatoes with skin
carrots, raw	baby carrots
broccoli, raw	fresh broccoli florets
spinach, raw	baby spinach leaves
lettuce, iceberg (includes crisphead types), raw	iceberg lettuce
lettuce, romaine, raw	iceberg lettuce
tomatoes, red, ripe, raw, year round average	muir's diced tomatoes
tomatoes, red, ripe, canned, packed in tomato juice	muir's diced tomatoes
onions, raw	yellow onion
peppers, sweet, red, raw	red bell pepper
peppers, sweet, green, raw	red bell pepper
apples, raw, with skin (includes usda commodity food a343)	granny smith apple with peel
apples, raw, without skin	granny smith apple with peel
bananas, raw	banana
oranges, raw, all commercial varieties	navel orange
grapes, red or green (european type, such as thompson seedless), raw	red grapes
strawberries, raw	fresh strawberries
blueberries, raw	fresh blueberries
oil, olive, salad or cooking	olive oil
oil, vegetable, canola	olive oil
oil, vegetable, corn	olive oil
oil, vegetable, soybean	olive oil
vinegar, cider	olive oil
nuts, almonds	raw almonds
nuts, walnuts, english	raw almonds
nuts, peanuts, all types, dry-roasted, without salt	raw almonds
seeds, sunflower seed kernels, dry roasted, without salt	raw almonds
beans, kidney, red, mature seeds, cooked, boiled, without salt	kidney beans
beans, black, mature seeds, cooked, boiled, without salt	kidney beans
beans, pinto, mature seeds, cooked, boiled, without salt	kidney beans
lentils, mature seeds, cooked, boiled, without salt	kidney beans
chickpeas (garbanzo beans, bengal gram), mature seeds, cooked, boiled, without salt	kidney beans
yogurt, plain, whole milk	greek yogurt
yogurt, plain, low fat	greek yogurt
ice cream, vanilla	vanilla ice cream
cheese, cottage, creamed, large or small curd	cottage cheese
cheese, mozzarella, part skim milk	part skim mozzarella cheese
cheese, swiss	part skim mozzarella cheese
cheese, american, pasteurized process	part skim mozzarella cheese
juice, orange, raw	orange juice
juice, apple, canned or bottled, unsweetened, with added ascorbic acid	original apple sauce (tree top)
coffee, brewed from grounds, prepared with tap water	black coffee
tea, brewed, prepared with tap water	black coffee
beverages, carbonated, cola, regular	gatorade
beverages, water, tap, municipal	gatorade
sugar, granulated	white granulated sugar
honey	white granulated sugar
syrup, maple	white granulated sugar
flour, wheat, all-purpose, enriched, bleached	all purpose flour
flour, wheat, all-purpose, enriched, unbleached	all purpose flour
baking powder, double-acting, sodium aluminum phosphate	all purpose flour
baking soda	all purpose flour
salt, table	sea salt
pepper, black	black pepper
herbs, basil, fresh	chives
herbs, oregano, dried	chives
herbs, parsley, fresh	chives
spices, garlic powder	chives
spices, onion powder	chives
spices, paprika	chives
spices, cinnamon, ground	chives
margarine, regular, 80% fat, composite, stick, with salt	unsalted butter
shortening, vegetable, household, composite	unsalted butter
lard	unsalted butter
cream, whipped, cream topping, pressurized	whipped cream
cream, heavy whipping, fluid	whipped cream
sour cream, reduced fat	cream cheese
milk, buttermilk, fluid, cultured, lowfat	whole milk
milk, nonfat, fluid, with added vitamin a and vitamin d (fat free or skim)	whole milk
milk, lowfat, fluid, 1% milkfat, with added vitamin a and vitamin d	whole milk
cheese, cream	cream cheese
cheese, ricotta, whole milk	cottage cheese
cheese, parmesan, grated	part skim mozzarella cheese
cheese, feta	part skim mozzarella cheese
cheese, goat, soft type	part skim mozzarella cheese
cheese, blue	part skim mozzarella cheese
egg, white, raw, fresh	brown egg yolk
egg, whole, cooked, hard-boiled	whole brown egg
egg, whole, cooked, scrambled	whole brown egg
egg, whole, cooked, fried	whole brown egg
chicken, broiler or fryers, breast, skinless, boneless, meat only, cooked, roasted	chicken breast
chicken, broiler or fryers, thigh, skinless, boneless, meat only, cooked, roasted	chicken breast
chicken, broiler or fryers, wing, meat and skin, cooked, roasted	chicken breast
chicken, broiler or fryers, leg, meat and skin, cooked, roasted	chicken breast
turkey, whole, meat and skin, raw	chicken breast
turkey, breast, meat and skin, raw	chicken breast
turkey, thigh, meat and skin, raw	chicken breast
beef, ground, 85% lean meat / 15% fat, cooked, pan-browned	lean ground beef
beef, ground, 80% lean meat / 20% fat, cooked, pan-browned	lean ground beef
beef, ground, 90% lean meat / 10% fat, cooked, pan-browned	lean ground beef
beef, round, top round, separable lean only, trimmed to 1/8" fat, choice, cooked, broiled	lean ground beef
beef, chuck, shoulder clod, separable lean only, trimmed to 1/8" fat, choice, cooked, braised	lean ground beef
beef, loin, tenderloin, separable lean only, trimmed to 1/8" fat, choice, cooked, broiled	lean ground beef
pork, fresh, loin, center loin (chops), bone-in, separable lean only, cooked, broiled	lean ground beef
pork, fresh, loin, tenderloin, separable lean only, cooked, roasted	lean ground beef
pork, fresh, shoulder, whole, separable lean only, cooked, roasted	lean ground beef
fish, salmon, atlantic, farmed, cooked, dry heat	salmon
fish, salmon, chinook, cooked, dry heat	salmon
fish, tuna, light, canned in oil, drained solids	canned tuna in water
fish, tuna, yellowfin, cooked, dry heat	canned tuna in water
fish, cod, atlantic, cooked, dry heat	salmon
fish, halibut, atlantic and pacific, cooked, dry heat	salmon
shellfish, shrimp, mixed species, cooked, moist heat	salmon
bread, white, toasted	whole wheat bread
bread, whole-wheat, toasted	whole wheat bread
muffins, blueberry, commercially prepared	whole wheat bread
bagels, plain, enriched, with calcium propionate (includes onion, poppy, sesame)	whole wheat bread
crackers, saltines (includes oyster, soda, soup)	whole wheat bread
cereals, oats, instant, fortified, with cinnamon and spice, prepared with water	cooked oat bran
cereals, ready-to-eat, wheat, shredded, plain, sugar and salt free	cooked oat bran
cereals, ready-to-eat, corn flakes, plain, fortified	cooked oat bran
cereals, ready-to-eat, rice, crispy rice	cooked white rice
rice, white, long-grain, regular, cooked, unenriched	cooked white rice
rice, brown, long-grain, cooked	cooked white rice
pasta, cooked, enriched, without added salt	cooked white rice
quinoa, cooked	cooked white rice
oats, regular and quick, not fortified, dry	cooked oat bran
barley, pearled, raw	cooked oat bran
potatoes, russet, flesh and skin, baked	red potatoes with skin
potatoes, red, flesh and skin, boiled, cooked with skin	red potatoes with skin
sweet potato, cooked, baked in skin, without salt	red potatoes with skin
carrots, cooked, boiled, drained, without salt	baby carrots
broccoli, cooked, boiled, drained, without salt	fresh broccoli florets
spinach, cooked, boiled, drained, without salt	baby spinach leaves
asparagus, cooked, boiled, drained	baby spinach leaves
green beans, cooked, boiled, drained, without salt	baby spinach leaves
peas, green, cooked, boiled, drained, without salt	baby spinach leaves
corn, sweet, yellow, cooked, boiled, drained, without salt	baby carrots
cauliflower, cooked, boiled, drained, without salt	fresh broccoli florets
cabbage, common (danish, domestic, and pointed types), raw	iceberg lettuce
cabbage, common, cooked, boiled, drained, without salt	iceberg lettuce
brussels sprouts, cooked, boiled, drained, without salt	fresh broccoli florets
tomatoes, red, ripe, cooked	muir's diced tomatoes
onions, cooked, boiled, drained, without salt	yellow onion
peppers, sweet, red, cooked, boiled, drained, without salt	red bell pepper
peppers, sweet, green, cooked, boiled, drained, without salt	red bell pepper
mushrooms, white, raw	yellow onion
mushrooms, white, cooked, boiled, drained, without salt	yellow onion
celery, raw	baby carrots
cucumber, with peel, raw	baby carrots
radishes, raw	baby carrots
beets, raw	baby carrots
turnips, raw	baby carrots
squash, summer, zucchini, includes skin, raw	baby carrots
squash, summer, zucchini, includes skin, cooked, boiled, drained, without salt	baby carrots
squash, winter, acorn, raw	baby carrots
squash, winter, butternut, raw	baby carrots
pumpkin, raw	baby carrots
eggplant, raw	baby carrots
okra, raw	baby carrots
artichokes, (globe or french), raw	baby carrots
avocados, raw, all commercial varieties	baby carrots
apples, raw, with skin, red delicious	granny smith apple with peel
apples, raw, with skin, gala	granny smith apple with peel
apples, raw, with skin, granny smith	granny smith apple with peel
apples, raw, with skin, fuji	granny smith apple with peel
pears, raw	granny smith apple with peel
peaches, raw	navel orange
plums, raw	navel orange
cherries, sweet, raw	navel orange
apricots, raw	navel orange
nectarines, raw	navel orange
kiwifruit, green, raw	navel orange
mangos, raw	navel orange
papayas, raw	navel orange
pineapple, raw, all varieties	gold (golden) pineapple
cantaloupe, raw	navel orange
honeydew, raw	navel orange
watermelon, raw	navel orange
raspberries, raw	fresh strawberries
blackberries, raw	fresh blueberries
cranberries, raw	fresh blueberries
dates, deglet noor	dates
figs, raw	dates
raisins, seedless	dates
prunes, dehydrated (low-moisture), uncooked	dates
coconut meat, raw	dates
nuts, brazil nuts, dried, unblanched	raw almonds
nuts, cashews, dry roasted, without salt added	raw almonds
nuts, hazelnuts or filberts	raw almonds
nuts, macadamia nuts, dry roasted, without salt added	raw almonds
nuts, pecans	raw almonds
nuts, pine nuts, pignolia, dried	raw almonds
nuts, pistachios, dry roasted, without salt added	raw almonds
seeds, pumpkin and squash seed kernels, roasted, without salt	raw almonds
seeds, sesame seeds, whole, dried	raw almonds
beans, navy, mature seeds, cooked, boiled, without salt	kidney beans
beans, great northern, mature seeds, cooked, boiled, without salt	kidney beans
beans, lima, large, mature seeds, cooked, boiled, without salt	kidney beans
split peas, mature seeds, cooked, boiled, without salt	kidney beans
soybeans, green, cooked, boiled, drained, without salt	kidney beans
tofu, raw, regular, prepared with calcium sulfate	soy flour
tempeh	soy flour
soy milk, unsweetened, plain	whole milk
yogurt, vanilla, low fat	greek yogurt
yogurt, strawberry, low fat	greek yogurt
frozen yogurt, vanilla, soft-serve	vanilla ice cream
sherbet, orange	vanilla ice cream
ice cream, chocolate	vanilla ice cream
ice cream, strawberry	vanilla ice cream
pudding, chocolate, ready-to-eat	vanilla ice cream
custard, vanilla, prepared-from-recipe	vanilla ice cream
gelatin desserts, dry mix, reduced calorie, with aspartame, prepared with water	vanilla ice cream
cake, yellow, commercially prepared, with chocolate frosting	vanilla ice cream
cookies, chocolate chip, commercially prepared, regular, higher fat, enriched	vanilla ice cream
pie, apple, commercially prepared, enriched flour	original apple sauce (tree top)
doughnuts, cake-type, plain (includes unsugared, old-fashioned)	vanilla ice cream
candy, milk chocolate	vanilla ice cream
candy, hard	white granulated sugar
gum, chewing	white granulated sugar
juice, grape, canned or bottled, unsweetened, with added ascorbic acid	red grapes
juice, cranberry, unsweetened	fresh blueberries
juice, grapefruit, white, canned, unsweetened	orange juice
juice, lemon, raw	orange juice
juice, lime, raw	orange juice
juice, tomato, canned, without salt added	carrot juice
juice, vegetable, canned, low sodium	carrot juice
juice, carrot, canned	carrot juice
smoothies, fruit, without dairy	orange juice
beverages, tea, green, brewed, regular	black coffee
beverages, tea, black, brewed, prepared with tap water	black coffee
coffee, instant, regular, prepared with water	black coffee
beverages, energy drinks, red bull	gatorade
beverages, sports drinks	gatorade
beverages, soft drink, cola, without caffeine	gatorade
beverages, soft drink, ginger ale	gatorade
beverages, soft drink, lemon-lime soda	gatorade
beverages, soft drink, orange	gatorade
beverages, soft drink, pepper-type	gatorade
beverages, soft drink, root beer	gatorade
beverages, water, bottled, generic	gatorade
wine, table, red	gatorade
wine, table, white	gatorade
beer, regular, budweiser	gatorade
beer, light, bud light	gatorade
spirits, distilled, all (gin, rum, vodka, whiskey) 80 proof	gatorade
alcoholic beverage, wine, table, red, burgundy	gatorade
alcoholic beverage, wine, table, white, riesling	gatorade
molasses	white granulated sugar
corn syrup, high-fructose	white granulated sugar
jams and preserves, apricot	white granulated sugar
jelly, grape	white granulated sugar
syrup, corn, light	white granulated sugar
artificial sweeteners, aspartame, granulated	white granulated sugar
artificial sweeteners, saccharin	white granulated sugar
artificial sweeteners, sucralose, granulated	white granulated sugar
flour, rice, brown	all purpose flour
flour, rice, white	all purpose flour
flour, corn, whole-grain, yellow	all purpose flour
cornstarch	all purpose flour
tapioca, pearl, dry	all purpose flour
yeast, baker's, active dry	all purpose flour
cream of tartar	all purpose flour
vanilla extract	chives
almond extract	chives
lemon juice, raw	orange juice
lime juice, raw	orange juice
vinegar, white	olive oil
vinegar, balsamic	olive oil
vinegar, red wine	olive oil
soy sauce made from soy and wheat (shoyu)	low sodium chicken broth
sauce, worcestershire	low sodium chicken broth
sauce, tabasco	chives
sauce, barbecue	low sodium chicken broth
ketchup	muir's diced tomatoes
mustard, prepared, yellow	chives
mayonnaise, regular	cream cheese
salad dressing, ranch dressing, regular	cream cheese
salad dressing, italian dressing, regular	olive oil
salad dressing, french dressing, regular	olive oil
salad dressing, thousand island, regular	cream cheese
salad dressing, caesar dressing	cream cheese
peanut butter, smooth style, with salt	raw almonds
jam, strawberry	fresh strawberries
jelly, apple	original apple sauce (tree top)
preserves, orange marmalade	navel orange
relish, pickle, sweet	yellow onion
pickles, cucumber, dill or kosher dill	baby carrots
olives, ripe, canned (small-extra large)	yellow onion
capers, canned	chives
coconut, dried (desiccated), sweetened, flaked, packaged	dates
coconut milk, canned (liquid expressed from grated meat and water)	whole milk
coconut water (liquid from coconuts)	gatorade
protein powder, whey based	soy flour
nutritional yeast	soy flour
seaweed, spirulina, dried	soy flour
supplement, vitamin c	chives
supplement, vitamin d	whole milk
supplement, calcium	whole milk
supplement, iron	chives
supplement, multivitamin	chives
fish oil, cod liver	olive oil
flaxseed oil	olive oil
sesame oil	olive oil
coconut oil	olive oil
avocado oil	olive oil
grapeseed oil	olive oil
sunflower oil	olive oil
safflower oil	olive oil
peanut oil	olive oil
vegetable oil spray	olive oil
cooking spray, original	olive oil
butter flavored spray	unsalted butter
butter, whipped, with salt	unsalted butter
butter, light, with salt	unsalted butter
ghee (clarified butter)	unsalted butter
margarine, regular, 80% fat, composite, tub, with salt	unsalted butter
margarine, light	unsalted butter
margarine, fat-free	unsalted butter
spread, plant stanol ester based	unsalted butter
cream cheese, fat free	cream cheese
cream cheese, neufchatel	cream cheese
sour cream, fat free	cream cheese
sour cream, light	cream cheese
half and half, fat free	half and half
coffee creamer, liquid, flavored	half and half
coffee creamer, powdered	half and half
non-dairy coffee whitener, liquid, used on cereal	half and half
whipped topping, frozen	whipped cream
whipped topping, pressurized	whipped cream
whipped cream substitute, dietetic, made from powdered mix	whipped cream
milk, chocolate, fluid, commercial, reduced fat, with added vitamin a and vitamin d	whole milk
milk, chocolate, fluid, commercial, whole, with added vitamin a and vitamin d	whole milk
milk, strawberry flavor, fluid, commercial, whole, with added vitamin a and vitamin d	whole milk
milk, goat, fluid, with added vitamin d	whole milk
milk, sheep, fluid	whole milk
milk, human, mature, fluid	whole milk
milk, evaporated, canned, whole, with added vitamin d	whole milk
milk, evaporated, canned, nonfat, with added vitamin a and vitamin d	whole milk
milk, condensed, canned, sweetened	whole milk
milk, dry, whole, with added vitamin d	whole milk
milk, dry, nonfat, instant, with added vitamin a and vitamin d	whole milk
milk, lactose free, fluid, reduced fat	whole milk
milk, protein fortified, fluid	whole milk
milk substitute, fluid, with lauric acid oil	whole milk
rice milk, fluid	whole milk
soy milk, chocolate, fluid	whole milk
soy milk, vanilla, fluid	whole milk
almond milk, unsweetened, plain, shelf stable	whole milk
almond milk, vanilla, refrigerated	whole milk
coconut milk beverage, unsweetened, in a carton	whole milk
oat milk, plain, refrigerated	whole milk
hemp milk, unsweetened	whole milk
pea milk, unsweetened, plain	whole milk
kefir, lowfat, plain, lifeway	greek yogurt
kefir, whole milk, plain	greek yogurt
yogurt, greek, plain, nonfat	greek yogurt
yogurt, greek, plain, lowfat	greek yogurt
yogurt, greek, plain, whole milk	greek yogurt
yogurt, greek, strawberry, nonfat	greek yogurt
yogurt, greek, vanilla, nonfat	greek yogurt
yogurt, greek, blueberry, nonfat	greek yogurt
yogurt drink, lowfat, with fruit	greek yogurt
cheese, american, nonfat or fat free	part skim mozzarella cheese
cheese, american, reduced fat	part skim mozzarella cheese
cheese, cheddar, reduced fat	cottage cheese
cheese, cheddar, nonfat	cottage cheese
cheese, colby	cottage cheese
cheese, mexican, queso blanco	part skim mozzarella cheese
cheese, mexican, queso fresco	cottage cheese
cheese, monterey	part skim mozzarella cheese
cheese, muenster	part skim mozzarella cheese
cheese, provolone	part skim mozzarella cheese
string cheese, mozzarella	part skim mozzarella cheese
cheese, brie	cream cheese
cheese, camembert	cream cheese
cheese, gruyere	part skim mozzarella cheese
cheese, romano	part skim mozzarella cheese
cheese, asiago	part skim mozzarella cheese
cheese, fontina	part skim mozzarella cheese
cheese, limburger	part skim mozzarella cheese
cheese, roquefort	part skim mozzarella cheese
cheese, stilton	part skim mozzarella cheese
cheese food, cold pack, american	part skim mozzarella cheese
cheese spread, american or cheddar cheese base, reduced fat	part skim mozzarella cheese
cottage cheese, nonfat, uncreamed, dry, large or small curd	cottage cheese
cottage cheese, lowfat, 2% milkfat	cottage cheese
cottage cheese, lowfat, 1% milkfat	cottage cheese
ricotta cheese, part skim milk	cottage cheese
ricotta cheese, nonfat	cottage cheese
mascarpone cheese	cream cheese
quark cheese	cottage cheese
farmer cheese	cottage cheese
pot cheese	cottage cheese
paneer	cottage cheese
halloumi cheese	part skim mozzarella cheese
cheese, processed, swiss	part skim mozzarella cheese
cheese product, pasteurized process, american, reduced fat	part skim mozzarella cheese
egg substitute, liquid	brown egg yolk
egg substitute, powder	brown egg yolk
egg, duck, whole, fresh, raw	whole brown egg
egg, goose, whole, fresh, raw	whole brown egg
egg, quail, whole, fresh, raw	whole brown egg
egg, turkey, whole, fresh, raw	whole brown egg
egg, chicken, whole, fresh, raw, grade aa	whole brown egg
egg, chicken, whole, fresh, raw, grade a	whole brown egg
egg, chicken, whole, fresh, raw, grade b	whole brown egg
egg, white, dried	brown egg yolk
egg, yolk, dried	brown egg yolk
egg, whole, dried	whole brown egg
omelet, plain	whole brown egg
quiche lorraine, frozen, prepared	whole brown egg
egg rolls, vegetable, frozen, prepared	whole brown egg
chicken, canned, meat only, with broth	chicken breast
chicken, mechanically separated, raw	chicken breast
chicken, ground, raw	chicken breast
chicken, roasting, meat and skin, cooked, roasted	chicken breast
chicken, stewing, meat and skin, cooked, stewed	chicken breast
chicken, capons, meat and skin, cooked, roasted	chicken breast
chicken, cornish game hens, meat and skin, cooked, roasted	chicken breast
chicken nuggets, frozen, cooked	chicken breast
chicken patty, frozen, cooked	chicken breast
chicken tenders, breaded, frozen, prepared	chicken breast
turkey, ground, 85% lean, 15% fat, raw	chicken breast
turkey, ground, 93% lean, 7% fat, raw	chicken breast
turkey, ground, 99% lean, 1% fat, raw	chicken breast
turkey, retail parts, breast, meat only, raw	chicken breast
turkey, retail parts, thigh, meat only, raw	chicken breast
turkey, retail parts, wing, meat and skin, raw	chicken breast
turkey, retail parts, drumstick, meat and skin, raw	chicken breast
turkey, all classes, meat and skin, cooked, roasted	chicken breast
turkey, fryer-roasters, meat and skin, cooked, roasted	chicken breast
turkey, young hens, meat and skin, cooked, roasted	chicken breast
turkey, young toms, meat and skin, cooked, roasted	chicken breast
turkey bacon, microwaved	chicken breast
turkey ham, sliced, extra lean, prepackaged or deli-sliced	chicken breast
turkey, deli meat, oven roasted, luncheon meat	chicken breast
chicken, deli meat, rotisserie seasoned, sliced, prepackaged	chicken breast
ham, sliced, regular (approximately 11% fat)	lean ground beef
ham, sliced, extra lean (approximately 5% fat)	lean ground beef
ham, honey, sliced, extra lean (approximately 5% fat)	lean ground beef
bacon, turkey, microwaved	chicken breast
bacon, pork, cured, cooked, microwaved	lean ground beef
canadian bacon, cooked, pan-fried	lean ground beef
sausage, pork, fresh, cooked	lean ground beef
sausage, turkey, fresh, cooked	chicken breast
sausage, chicken, fresh, cooked	chicken breast
sausage, beef, fresh, cooked	lean ground beef
frankfurter, beef	lean ground beef
frankfurter, chicken	chicken breast
frankfurter, turkey	chicken breast
frankfurter, pork	lean ground beef
bologna, beef	lean ground beef
bologna, chicken, turkey	chicken breast
pastrami, beef, 98% fat-free	lean ground beef
corned beef, cured, cooked	lean ground beef
salami, italian, pork	lean ground beef
pepperoni, beef and pork, sliced	lean ground beef
liverwurst spread	lean ground beef
duck, domesticated, meat and skin, cooked, roasted	chicken breast
goose, domesticated, meat and skin, cooked, roasted	chicken breast
rabbit, domesticated, composite of cuts, cooked, roasted	lean ground beef
venison, cooked, roasted	lean ground beef
bison, ground, grass-fed, cooked	lean ground beef
lamb, domestic, composite of trimmed retail cuts, separable lean only, trimmed to 1/4" fat, choice, cooked	lean ground beef
veal, composite of trimmed retail cuts, separable lean only, cooked	lean ground beef
fish, anchovies, european, canned in oil, drained solids	canned tuna in water
fish, bass, freshwater, mixed species, cooked, dry heat	salmon
fish, catfish, channel, farmed, cooked, dry heat	salmon
fish, flounder, cooked, dry heat	salmon
fish, haddock, cooked, dry heat	salmon
fish, herring, atlantic, cooked, dry heat	salmon
fish, mackerel, atlantic, cooked, dry heat	salmon
fish, mahi mahi, cooked, dry heat	salmon
fish, orange roughy, cooked, dry heat	salmon
fish, perch, mixed species, cooked, dry heat	salmon
fish, pike, northern, cooked, dry heat	salmon
fish, pollock, alaska, cooked, dry heat	salmon
fish, rockfish, pacific, mixed species, cooked, dry heat	salmon
fish, sardine, atlantic, canned in oil, drained solids with bone	canned tuna in water
fish, sea bass, mixed species, cooked, dry heat	salmon
fish, snapper, mixed species, cooked, dry heat	salmon
fish, sole, cooked, dry heat	salmon
fish, swordfish, cooked, dry heat	salmon
fish, tilapia, cooked, dry heat	salmon
fish, trout, mixed species, cooked, dry heat	salmon
fish, tuna, bluefin, fresh, cooked, dry heat	canned tuna in water
fish, whiting, mixed species, cooked, dry heat	salmon
fishsticks, frozen, prepared	salmon
fish, salmon, coho, farmed, cooked, dry heat	salmon
fish, salmon, pink, canned, solids with bone and liquid	canned tuna in water
fish, salmon, sockeye, canned, drained solids with bone	canned tuna in water
crab, alaska king, cooked, moist heat	salmon
crab, blue, cooked, moist heat	salmon
crab, dungeness, cooked, moist heat	salmon
lobster, northern, cooked, moist heat	salmon
crawfish, mixed species, farmed, cooked, moist heat	salmon
scallops, mixed species, cooked, breaded and fried	salmon
oysters, eastern, farmed, cooked, dry heat	salmon
clams, mixed species, cooked, moist heat	salmon
mussels, blue, cooked, moist heat	salmon
squid, mixed species, cooked, fried	salmon
octopus, common, cooked, moist heat	salmon
abalone, mixed species, cooked, fried	salmon
conch, baked or broiled	salmon
eel, mixed species, cooked, dry heat	salmon
croaker, atlantic, cooked, dry heat	salmon
drum, freshwater, cooked, dry heat	salmon
grouper, mixed species, cooked, dry heat	salmon
monkfish, cooked, dry heat	salmon
porgy, cooked, dry heat	salmon
sheepshead, cooked, dry heat	salmon
spot, cooked, dry heat	salmon
striped bass, cooked, dry heat	salmon
sturgeon, mixed species, cooked, dry heat	salmon
sucker, white, cooked, dry heat	salmon
sunfish, pumpkin seed, cooked, dry heat	salmon
tilefish, cooked, dry heat	salmon
weakfish, cooked, dry heat	salmon
wolffish, atlantic, cooked, dry heat	salmon
yellowtail, mixed species, cooked, dry heat	salmon