onions, spring or scallions (includes tops and bulb), raw	onions, spring or scallions (includes tops and bulb), raw
beef, ground, 75% lean meat / 25% fat, patty, cooked, broiled	beef, ground, 75% lean meat / 25% fat, patty, cooked, broiled
beef, ground, 80% lean meat / 20% fat, patty, cooked, broiled	beef, ground, 80% lean meat / 20% fat, patty, cooked, broiled
beef, ground, 85% lean meat / 15% fat, patty, cooked, broiled	beef, ground, 85% lean meat / 15% fat, patty, cooked, broiled
beef, ground, 90% lean meat / 10% fat, patty, cooked, broiled	beef, ground, 90% lean meat / 10% fat, patty, cooked, broiled
beef, ground, 95% lean meat / 5% fat, crumbles, cooked, pan-browned	beef, ground, 95% lean meat / 5% fat, crumbles, cooked, pan-browned
beef, ground, 95% lean meat / 5% fat, patty, cooked, broiled	beef, ground, 95% lean meat / 5% fat, patty, cooked, broiled
beans, snap, green, frozen, all styles, microwaved	beans, snap, green, frozen, all styles, microwaved
beans, snap, green, frozen, all styles, unprepared	beans, snap, green, frozen, all styles, unprepared
beans, snap, green, frozen, cooked, boiled, drained without salt	beans, snap, green, frozen, cooked, boiled, drained without salt
beans, snap, green, frozen, cooked, boiled, drained with salt	beans, snap, green, frozen, cooked, boiled, drained with salt
beans, snap, green, raw	beans, snap, green, raw
beans, snap, green, canned, regular pack, drained solids	beans, snap, green, canned, regular pack, drained solids
beans, snap, green, canned, no salt added, drained solids	beans, snap, green, canned, no salt added, drained solids
beans, snap, green, cooked, boiled, drained, without salt	beans, snap, green, cooked, boiled, drained, without salt
beans, snap, green, cooked, boiled, drained, with salt	beans, snap, green, cooked, boiled, drained, with salt
broccoli, raw	broccoli, raw
broccoli, cooked, boiled, drained, without salt	broccoli, cooked, boiled, drained, without salt
broccoli, cooked, boiled, drained, with salt	broccoli, cooked, boiled, drained, with salt
broccoli, frozen, chopped, unprepared	broccoli, frozen, chopped, unprepared
broccoli, frozen, chopped, cooked, boiled, drained, without salt	broccoli, frozen, chopped, cooked, boiled, drained, without salt
broccoli, frozen, chopped, cooked, boiled, drained, with salt	broccoli, frozen, chopped, cooked, boiled, drained, with salt
broccoli, frozen, spears, unprepared	broccoli, frozen, spears, unprepared
broccoli, frozen, spears, cooked, boiled, drained, without salt	broccoli, frozen, spears, cooked, boiled, drained, without salt
broccoli, frozen, spears, cooked, boiled, drained, with salt	broccoli, frozen, spears, cooked, boiled, drained, with salt
carrots, raw	carrots, raw
carrots, cooked, boiled, drained, without salt	carrots, cooked, boiled, drained, without salt
carrots, cooked, boiled, drained, with salt	carrots, cooked, boiled, drained, with salt
carrots, frozen, unprepared	carrots, frozen, unprepared
carrots, frozen, cooked, boiled, drained, without salt	carrots, frozen, cooked, boiled, drained, without salt
carrots, frozen, cooked, boiled, drained, with salt	carrots, frozen, cooked, boiled, drained, with salt
carrots, canned, regular pack, drained solids	carrots, canned, regular pack, drained solids
carrots, canned, no salt added, drained solids	carrots, canned, no salt added, drained solids
corn, sweet, white, raw	corn, sweet, white, raw
corn, sweet, white, cooked, boiled, drained, without salt	corn, sweet, white, cooked, boiled, drained, without salt
corn, sweet, white, cooked, boiled, drained, with salt	corn, sweet, white, cooked, boiled, drained, with salt
corn, sweet, white, frozen, kernels cut off cob, unprepared	corn, sweet, white, frozen, kernels cut off cob, unprepared
corn, sweet, white, frozen, kernels cut off cob, boiled, drained, without salt	corn, sweet, white, frozen, kernels cut off cob, boiled, drained, without salt
corn, sweet, white, frozen, kernels cut off cob, boiled, drained, with salt	corn, sweet, white, frozen, kernels cut off cob, boiled, drained, with salt
corn, sweet, white, canned, whole kernel, regular pack, drained solids	corn, sweet, white, canned, whole kernel, regular pack, drained solids
corn, sweet, white, canned, whole kernel, no salt added, drained solids	corn, sweet, white, canned, whole kernel, no salt added, drained solids
corn, sweet, yellow, raw	corn, sweet, yellow, raw
corn, sweet, yellow, cooked, boiled, drained, without salt	corn, sweet, yellow, cooked, boiled, drained, without salt
corn, sweet, yellow, cooked, boiled, drained, with salt	corn, sweet, yellow, cooked, boiled, drained, with salt
corn, sweet, yellow, frozen, kernels cut off cob, unprepared	corn, sweet, yellow, frozen, kernels cut off cob, unprepared
corn, sweet, yellow, frozen, kernels cut off cob, boiled, drained, without salt	corn, sweet, yellow, frozen, kernels cut off cob, boiled, drained, without salt
corn, sweet, yellow, frozen, kernels cut off cob, boiled, drained, with salt	corn, sweet, yellow, frozen, kernels cut off cob, boiled, drained, with salt
corn, sweet, yellow, canned, whole kernel, regular pack, drained solids	corn, sweet, yellow, canned, whole kernel, regular pack, drained solids
corn, sweet, yellow, canned, whole kernel, no salt added, drained solids	corn, sweet, yellow, canned, whole kernel, no salt added, drained solids
potatoes, russet, flesh and skin, raw	potatoes, russet, flesh and skin, raw
potatoes, russet, flesh and skin, baked	potatoes, russet, flesh and skin, baked
potatoes, red, flesh and skin, raw	potatoes, red, flesh and skin, raw
potatoes, red, flesh and skin, baked	potatoes, red, flesh and skin, baked
potatoes, white, flesh and skin, raw	potatoes, white, flesh and skin, raw
potatoes, white, flesh and skin, baked	potatoes, white, flesh and skin, baked
sweet potato, raw, unprepared	sweet potato, raw, unprepared
sweet potato, cooked, baked in skin, flesh, without salt	sweet potato, cooked, baked in skin, flesh, without salt
sweet potato, cooked, baked in skin, flesh, with salt	sweet potato, cooked, baked in skin, flesh, with salt
sweet potato, cooked, boiled, without skin, flesh, without salt	sweet potato, cooked, boiled, without skin, flesh, without salt
sweet potato, cooked, boiled, without skin, flesh, with salt	sweet potato, cooked, boiled, without skin, flesh, with salt
tomatoes, red, ripe, raw, year round average	tomatoes, red, ripe, raw, year round average
tomatoes, red, ripe, cooked	tomatoes, red, ripe, cooked
tomatoes, red, ripe, canned, packed in tomato juice	tomatoes, red, ripe, canned, packed in tomato juice
tomatoes, red, ripe, canned, packed in tomato juice, no salt added	tomatoes, red, ripe, canned, packed in tomato juice, no salt added
mushrooms, white, raw	mushrooms, white, raw
mushrooms, white, cooked, boiled, drained, without salt	mushrooms, white, cooked, boiled, drained, without salt
mushrooms, white, cooked, boiled, drained, with salt	mushrooms, white, cooked, boiled, drained, with salt
mushrooms, portabella, raw	mushrooms, portabella, raw
mushrooms, portabella, grilled	mushrooms, portabella, grilled
mushrooms, shiitake, raw	mushrooms, shiitake, raw
mushrooms, shiitake, cooked, without salt	mushrooms, shiitake, cooked, without salt
zucchini, includes skin, raw	zucchini, includes skin, raw
zucchini, includes skin, cooked, boiled, drained, without salt	zucchini, includes skin, cooked, boiled, drained, without salt
zucchini, includes skin, cooked, boiled, drained, with salt	zucchini, includes skin, cooked, boiled, drained, with salt
squash, summer, crookneck and straightneck, raw	squash, summer, crookneck and straightneck, raw
squash, summer, crookneck and straightneck, cooked, boiled, drained, without salt	squash, summer, crookneck and straightneck, cooked, boiled, drained, without salt
squash, summer, crookneck and straightneck, cooked, boiled, drained, with salt	squash, summer, crookneck and straightneck, cooked, boiled, drained, with salt
squash, winter, acorn, raw	squash, winter, acorn, raw
squash, winter, acorn, cooked, baked, without salt	squash, winter, acorn, cooked, baked, without salt
squash, winter, acorn, cooked, baked, with salt	squash, winter, acorn, cooked, baked, with salt
squash, winter, butternut, raw	squash, winter, butternut, raw
squash, winter, butternut, cooked, baked, without salt	squash, winter, butternut, cooked, baked, without salt
squash, winter, butternut, cooked, baked, with salt	squash, winter, butternut, cooked, baked, with salt
eggplant, raw	eggplant, raw
eggplant, cooked, boiled, drained, without salt	eggplant, cooked, boiled, drained, without salt
eggplant, cooked, boiled, drained, with salt	eggplant, cooked, boiled, drained, with salt
peppers, sweet, red, raw	peppers, sweet, red, raw
peppers, sweet, red, cooked, boiled, drained, without salt	peppers, sweet, red, cooked, boiled, drained, without salt
peppers, sweet, red, cooked, boiled, drained, with salt	peppers, sweet, red, cooked, boiled, drained, with salt
peppers, sweet, red, frozen, chopped, unprepared	peppers, sweet, red, frozen, chopped, unprepared
peppers, sweet, red, frozen, chopped, cooked, boiled, drained, without salt	peppers, sweet, red, frozen, chopped, cooked, boiled, drained, without salt
peppers, sweet, red, frozen, chopped, cooked, boiled, drained, with salt	peppers, sweet, red, frozen, chopped, cooked, boiled, drained, with salt
peppers, sweet, green, raw	peppers, sweet, green, raw
peppers, sweet, green, cooked, boiled, drained, without salt	peppers, sweet, green, cooked, boiled, drained, without salt
peppers, sweet, green, cooked, boiled, drained, with salt	peppers, sweet, green, cooked, boiled, drained, with salt
peppers, sweet, green, frozen, chopped, unprepared	peppers, sweet, green, frozen, chopped, unprepared
peppers, sweet, green, frozen, chopped, cooked, boiled, drained, without salt	peppers, sweet, green, frozen, chopped, cooked, boiled, drained, without salt
peppers, sweet, green, frozen, chopped, cooked, boiled, drained, with salt	peppers, sweet, green, frozen, chopped, cooked, boiled, drained, with salt
peppers, sweet, yellow, raw	peppers, sweet, yellow, raw
onions, raw	onions, raw
onions, cooked, boiled, drained, without salt	onions, cooked, boiled, drained, without salt
onions, cooked, boiled, drained, with salt	onions, cooked, boiled, drained, with salt
onions, frozen, chopped, unprepared	onions, frozen, chopped, unprepared
onions, frozen, chopped, cooked, boiled, drained, without salt	onions, frozen, chopped, cooked, boiled, drained, without salt
onions, frozen, chopped, cooked, boiled, drained, with salt	onions, frozen, chopped, cooked, boiled, drained, with salt
garlic, raw	garlic, raw
celery, raw	celery, raw
celery, cooked, boiled, drained, without salt	celery, cooked, boiled, drained, without salt
celery, cooked, boiled, drained, with salt	celery, cooked, boiled, drained, with salt
cucumbers, with peel, raw	cucumbers, with peel, raw
cucumbers, peeled, raw	cucumbers, peeled, raw
lettuce, iceberg (includes crisphead types), raw	lettuce, iceberg (includes crisphead types), raw
lettuce, romaine, raw	lettuce, romaine, raw
lettuce, green leaf, raw	lettuce, green leaf, raw
lettuce, red leaf, raw	lettuce, red leaf, raw
spinach, raw	spinach, raw
spinach, cooked, boiled, drained, without salt	spinach, cooked, boiled, drained, without salt
spinach, cooked, boiled, drained, with salt	spinach, cooked, boiled, drained, with salt
spinach, frozen, chopped or leaf, unprepared	spinach, frozen, chopped or leaf, unprepared
spinach, frozen, chopped or leaf, cooked, boiled, drained, without salt	spinach, frozen, chopped or leaf, cooked, boiled, drained, without salt
spinach, frozen, chopped or leaf, cooked, boiled, drained, with salt	spinach, frozen, chopped or leaf, cooked, boiled, drained, with salt
spinach, canned, regular pack, drained solids	spinach, canned, regular pack, drained solids
kale, raw	kale, raw
kale, cooked, boiled, drained, without salt	kale, cooked, boiled, drained, without salt
kale, cooked, boiled, drained, with salt	kale, cooked, boiled, drained, with salt
kale, frozen, cooked, boiled, drained, without salt	kale, frozen, cooked, boiled, drained, without salt
kale, frozen, cooked, boiled, drained, with salt	kale, frozen, cooked, boiled, drained, with salt
cabbage, common (danish, domestic, and pointed types), raw	cabbage, common (danish, domestic, and pointed types), raw
cabbage, common (danish, domestic, and pointed types), cooked, boiled, drained, without salt	cabbage, common (danish, domestic, and pointed types), cooked, boiled, drained, without salt
cabbage, common (danish, domestic, and pointed types), cooked, boiled, drained, with salt	cabbage, common (danish, domestic, and pointed types), cooked, boiled, drained, with salt
cabbage, red, raw	cabbage, red, raw
cabbage, red, cooked, boiled, drained, without salt	cabbage, red, cooked, boiled, drained, without salt
cabbage, red, cooked, boiled, drained, with salt	cabbage, red, cooked, boiled, drained, with salt
brussels sprouts, raw	brussels sprouts, raw
brussels sprouts, cooked, boiled, drained, without salt	brussels sprouts, cooked, boiled, drained, without salt
brussels sprouts, cooked, boiled, drained, with salt	brussels sprouts, cooked, boiled, drained, with salt
brussels sprouts, frozen, cooked, boiled, drained, without salt	brussels sprouts, frozen, cooked, boiled, drained, without salt
brussels sprouts, frozen, cooked, boiled, drained, with salt	brussels sprouts, frozen, cooked, boiled, drained, with salt
cauliflower, raw	cauliflower, raw
cauliflower, cooked, boiled, drained, without salt	cauliflower, cooked, boiled, drained, without salt
cauliflower, cooked, boiled, drained, with salt	cauliflower, cooked, boiled, drained, with salt
cauliflower, frozen, cooked, boiled, drained, without salt	cauliflower, frozen, cooked, boiled, drained, without salt
cauliflower, frozen, cooked, boiled, drained, with salt	cauliflower, frozen, cooked, boiled, drained, with salt
asparagus, raw	asparagus, raw
asparagus, cooked, boiled, drained	asparagus, cooked, boiled, drained
asparagus, frozen, cooked, boiled, drained, without salt	asparagus, frozen, cooked, boiled, drained, without salt
asparagus, frozen, cooked, boiled, drained, with salt	asparagus, frozen, cooked, boiled, drained, with salt
asparagus, canned, drained solids	asparagus, canned, drained solids
artichokes, (globe or french), raw	artichokes, (globe or french), raw
artichokes, (globe or french), cooked, boiled, drained, without salt	artichokes, (globe or french), cooked, boiled, drained, without salt
artichokes, (globe or french), cooked, boiled, drained, with salt	artichokes, (globe or french), cooked, boiled, drained, with salt
artichokes, (globe or french), frozen, cooked, boiled, drained, without salt	artichokes, (globe or french), frozen, cooked, boiled, drained, without salt
artichokes, (globe or french), frozen, cooked, boiled, drained, with salt	artichokes, (globe or french), frozen, cooked, boiled, drained, with salt
avocados, raw, all commercial varieties	avocados, raw, all commercial varieties
avocados, raw, california	avocados, raw, california
avocados, raw, florida	avocados, raw, florida
olives, ripe, canned (small-extra large)	olives, ripe, canned (small-extra large)
olives, green, canned, pickled	olives, green, canned, pickled
pickles, cucumber, dill or kosher dill	pickles, cucumber, dill or kosher dill
pickles, cucumber, sweet (includes bread and butter pickles)	pickles, cucumber, sweet (includes bread and butter pickles)
radishes, raw	radishes, raw
beets, raw	beets, raw
beets, cooked, boiled, drained	beets, cooked, boiled, drained
beets, canned, drained solids	beets, canned, drained solids
turnips, raw	turnips, raw
turnips, cooked, boiled, drained, without salt	turnips, cooked, boiled, drained, without salt
turnips, cooked, boiled, drained, with salt	turnips, cooked, boiled, drained, with salt
parsnips, raw	parsnips, raw
parsnips, cooked, boiled, drained, without salt	parsnips, cooked, boiled, drained, without salt
parsnips, cooked, boiled, drained, with salt	parsnips, cooked, boiled, drained, with salt
rutabagas, raw	rutabagas, raw
rutabagas, cooked, boiled, drained, without salt	rutabagas, cooked, boiled, drained, without salt
rutabagas, cooked, boiled, drained, with salt	rutabagas, cooked, boiled, drained, with salt
leeks, (bulb and lower leaf-portion), raw	leeks, (bulb and lower leaf-portion), raw
leeks, (bulb and lower leaf-portion), cooked, boiled, drained, without salt	leeks, (bulb and lower leaf-portion), cooked, boiled, drained, without salt
leeks, (bulb and lower leaf-portion), cooked, boiled, drained, with salt	leeks, (bulb and lower leaf-portion), cooked, boiled, drained, with salt
shallots, raw	shallots, raw
fennel, bulb, raw	fennel, bulb, raw
okra, raw	okra, raw
okra, cooked, boiled, drained, without salt	okra, cooked, boiled, drained, without salt
okra, cooked, boiled, drained, with salt	okra, cooked, boiled, drained, with salt
okra, frozen, cooked, boiled, drained, without salt	okra, frozen, cooked, boiled, drained, without salt
okra, frozen, cooked, boiled, drained, with salt	okra, frozen, cooked, boiled, drained, with salt
parsley, fresh	parsley, fresh
cilantro, raw	cilantro, raw
basil, fresh	basil, fresh
oregano, fresh	oregano, fresh
thyme, fresh	thyme, fresh
rosemary, fresh	rosemary, fresh
sage, ground	sage, ground
dill weed, fresh	dill weed, fresh
chives, raw	chives, raw
mint, fresh	mint, fresh
ginger root, raw	ginger root, raw
horseradish, prepared	horseradish, prepared
wasabi, root, raw	wasabi, root, raw
watercress, raw	watercress, raw
arugula, raw	arugula, raw
endive, raw	endive, raw
radicchio, raw	radicchio, raw
bok choy (pak-choi), raw	bok choy (pak-choi), raw
bok choy (pak-choi), cooked, boiled, drained, without salt	bok choy (pak-choi), cooked, boiled, drained, without salt
bok choy (pak-choi), cooked, boiled, drained, with salt	bok choy (pak-choi), cooked, boiled, drained, with salt
swiss chard, raw	swiss chard, raw
swiss chard, cooked, boiled, drained, without salt	swiss chard, cooked, boiled, drained, without salt
swiss chard, cooked, boiled, drained, with salt	swiss chard, cooked, boiled, drained, with salt
collards, raw	collards, raw
collards, cooked, boiled, drained, without salt	collards, cooked, boiled, drained, without salt
collards, cooked, boiled, drained, with salt	collards, cooked, boiled, drained, with salt
mustard greens, raw	mustard greens, raw
mustard greens, cooked, boiled, drained, without salt	mustard greens, cooked, boiled, drained, without salt
mustard greens, cooked, boiled, drained, with salt	mustard greens, cooked, boiled, drained, with salt
turnip greens, raw	turnip greens, raw
turnip greens, cooked, boiled, drained, without salt	turnip greens, cooked, boiled, drained, without salt
turnip greens, cooked, boiled, drained, with salt	turnip greens, cooked, boiled, drained, with salt
turnip greens, frozen, cooked, boiled, drained, without salt	turnip greens, frozen, cooked, boiled, drained, without salt
turnip greens, frozen, cooked, boiled, drained, with salt	turnip greens, frozen, cooked, boiled, drained, with salt