cheese, brie	cheese, brie
cheese, muenster	cheese, muenster
cheese, cottage, creamed, large or small curd	cheese, cottage, creamed, large or small curd
milk, dry, nonfat, regular, with added vitamin a and vitamin d	milk, dry, nonfat, regular, with added vitamin a and vitamin d
cream, fluid, light (coffee cream or table cream)	cream, fluid, light (coffee cream or table cream)
dessert topping, semi solid, frozen	dessert topping, semi solid, frozen
cheese, mexican, queso asadero	cheese, mexican, queso asadero
cheese, goat, semisoft type	cheese, goat, semisoft type
milk, chocolate, lowfat, with added vitamin a and vitamin d	milk, chocolate, fluid, commercial, lowfat, with added vitamin a and vitamin d
milk, canned, condensed, sweetened	milk, canned, condensed, sweetened
butter oil, anhydrous	butter oil, anhydrous
spices, celery seed	spices, celery seed
milk, buttermilk, fluid, cultured, lowfat	milk, buttermilk, fluid, cultured, lowfat
salt, table, iodized	salt, table, iodized
garlic, raw	garlic, raw
ginger root, raw	ginger root, raw
celery, raw	celery, raw
cassava, raw	cassava, raw
cookies, animal crackers (includes arrowroot, tea biscuits)	cookies, animal crackers (includes arrowroot, tea biscuits)
broccoli, raw	broccoli, raw
peas, green, raw	peas, green, raw
pancakes, whole wheat, dry mix, incomplete	pancakes, whole-wheat, dry mix, incomplete
pumpkin, raw	pumpkin, raw
chard, swiss, raw	chard, swiss, raw
beverages, almond milk, unsweetened, shelf stable	beverages, almond milk, unsweetened, shelf stable
honey	honey
cabbage, red, raw	cabbage, red, raw
rhubarb, raw	rhubarb, raw
spinach, raw	spinach, raw
bread, multi-grain (includes whole-grain)	bread, multi-grain (includes whole-grain)
watermelon, raw	watermelon, raw
mangos, raw	mangos, raw
pomegranates, raw	pomegranates, raw
carrot juice, canned	carrot juice, canned
chives, raw	chives, raw
alfalfa seeds, sprouted, raw	alfalfa seeds, sprouted, raw
brussels sprouts, raw	brussels sprouts, raw
lemon peel, raw	lemon peel, raw
figs, raw	figs, raw
marmalade, orange	marmalade, orange
potato flour	potato flour
watercress, raw	watercress, raw
kumquats, raw	kumquats, raw
beverages, coconut milk, sweetened, fortified with calcium, vitamins a, b12, d2	beverages, coconut milk, sweetened, fortified with calcium, vitamins a, b12, d2
chicken breast, deli, rotisserie seasoned, sliced, prepackaged	chicken, breast, boiled, sliced
chicken, broiler, rotisserie, bbq, drumstick, meat only	chicken, broiler or fryers, breast, skinless, boneless, meat only, cooked, braised
chicken, broiler, rotisserie, bbq, drumstick, meat and skin	fruit cocktail, (peach and pineapple and pear and grape and cherry), canned, water pack, solids and liquids
chicken, broiler, rotisserie, bbq, breast, meat only	chicken, broiler or fryers, breast, skinless, boneless, meat only, cooked, braised
cheese, cheddar, reduced fat (includes foods for usda's food distribution program)	cheese, cheddar (includes foods for usda's food distribution program)
chicken, broiler, rotisserie, bbq, wing, meat and skin	fruit cocktail, (peach and pineapple and pear and grape and cherry), canned, water pack, solids and liquids
chicken, broiler or fryers, breast, skinless, boneless, meat only, raw	chicken, broiler or fryers, breast, skinless, boneless, meat only, cooked, braised
fast foods, fried chicken, breast, meat and skin and breading	fruit cocktail, (peach and pineapple and pear and grape and cherry), canned, water pack, solids and liquids
turkey, whole, meat only, with added solution, roasted	pork, cured, ham -- water added, whole, boneless, separable lean only, heated, roasted
turkey, whole, meat only, cooked, roasted	pork, fresh, loin, whole, separable lean only, cooked, roasted
bread, naan, whole wheat, commercially prepared, refrigerated	bread, white, commercially prepared (includes soft bread crumbs)
chicken, broiler, rotisserie, bbq, thigh, meat only	chicken, broiler or fryers, breast, skinless, boneless, meat only, cooked, braised
orange juice, frozen concentrate, unsweetened, undiluted, with added calcium	apple juice, frozen concentrate, unsweetened, undiluted, without added ascorbic acid
rice and vermicelli mix, rice pilaf flavor, unprepared	fruit cocktail, (peach and pineapple and pear and grape and cherry), canned, water pack, solids and liquids
duck, domesticated, meat and skin, cooked, roasted	duck, domesticated, meat and skin, raw
restaurant, chinese, vegetable chow mein, without meat or noodles	restaurant, chinese, chicken chow mein
beverages, nestle, boost plus, nutritional drink, ready-to-drink	sports drink, coca-cola, powerade, lemon-lime flavored, ready-to-drink
potatoes, mashed, ready-to-eat	turkey, stuffing, mashed potatoes w/gravy, assorted vegetables, frozen, microwaved
cabbage, kimchi	cabbage, red, raw
guava nectar, with sucralose, canned	guava nectar, canned
sauce, horseradish	sauce, tomato chili sauce, bottled, with salt
cake, snack cakes, not chocolate, with icing or filling, low-fat, with added fiber	cake, snack cakes, cupcakes, chocolate, with frosting, low-fat
blueberries, dried, sweetened	cranberries, dried, sweetened
pizza, cheese topping, thin crust, frozen, cooked	pizza, cheese topping, regular crust, frozen, cooked
turkey from whole, light meat, meat only, with added solution, cooked, roasted	turkey, whole, meat only, raw
strawberries, frozen, unsweetened (includes foods for usda's food distribution program)	rice, brown, long-grain, raw (includes foods for usda's food distribution program)
crackers, multigrain	cookies, animal crackers (includes arrowroot, tea biscuits)
bread, wheat, sprouted	bread, wheat, white wheat
fast foods, fried chicken, wing, meat and skin and breading	fruit cocktail, (peach and pineapple and pear and grape and cherry), canned, water pack, solids and liquids
chicken patty, frozen, cooked	pizza, meat and vegetable topping, rising crust, frozen, cooked
crackers, cheese, whole grain	crackers, standard snack-type, sandwich, with cheese filling
fast foods, chicken tenders	fast foods, chicken fillet sandwich, with cheese
lamb, composite of trimmed retail cuts, separable lean and fat, trimmed to 1/4" fat, choice, cooked	beef, composite of trimmed retail cuts, separable lean only, trimmed to 0" fat, all grades, cooked
turkey breast, sliced, prepackaged	turkey, breast, boiled/smoked, sliced
fast foods, fried chicken, drumstick, meat and skin with breading	fast foods, grilled chicken filet sandwich, with lettuce, tomato and spread
turkey, ground, cooked	turkey sausage, fresh, cooked
beef, round, eye of round roast, boneless, separable lean only, trimmed to 0" fat, all grades, raw	beef, round, eye of round, roast, separable lean only, trimmed to 1/8" fat, all grades, raw
beef, round, top round roast, boneless, separable lean only, trimmed to 0" fat, all grades, raw	beef, round, eye of round, roast, separable lean only, trimmed to 1/8" fat, all grades, raw
restaurant, chinese, chicken and vegetables	fruit cocktail, (peach and pineapple and pear and grape and cherry), canned, water pack, solids and liquids
jams, preserves, marmalade, reduced sugar	beverages, fruit juice drink, reduced sugar, with vitamin e added
rice crackers	rice cake, cracker (include hain mini rice cakes)
fast food, biscuit	fast foods, biscuit, with egg, cheese, and bacon
sausage, pork, chorizo, link or ground, cooked, pan-fried	pork sausage, fresh, cooked
tortillas, ready-to-bake or -fry, whole wheat	tortillas, ready-to-bake or -fry, flour, shelf stable
cereals ready-to-eat, nature's path, organic flax plus flakes	cereals ready-to-eat, nature's path, optimum
pizza rolls, frozen, unprepared	pizza, meat and vegetable topping, rising crust, frozen, cooked
bacon, turkey, microwaved	turkey, stuffing, mashed potatoes w/gravy, assorted vegetables, frozen, microwaved
cookies, sugar wafer, chocolate-covered	cookies, sugar wafers with creme filling, regular
restaurant, family style, coleslaw	restaurant, family style, fried mozzarella sticks
sauce, enchilada, red, mild, ready to serve	sauce, tomato chili sauce, bottled, with salt
cookie, chocolate, with icing or coating	cake, chocolate, commercially prepared with chocolate frosting, in-store bakery
rolls, dinner, sweet	rolls, dinner, rye
soup, beef barley, ready to serve	soup, beef broth or bouillon canned, ready-to-serve
restaurant, chinese, orange chicken	restaurant, chinese, chicken chow mein
jams, preserves, marmalades, sweetened with fruit juice	fruit flavored drink containing less than 3% fruit juice, with high vitamin c
beverages, chocolate powder, no sugar added	beverages, fruit juice drink, reduced sugar, with vitamin e added
snacks, potato chips, lightly salted	snacks, potato chips, plain, salted
lamb, ground, cooked, broiled	beef, ground, 75% lean meat / 25% fat, patty, cooked, broiled
cookies, coconut macaroon	archway home style cookies, coconut macaroon
jellies, no sugar (with sodium saccharin), any flavors	jams and preserves, dietetic (with sodium saccharin), any flavor
ice cream bar, stick or nugget, with crunch coating	ice cream, bar or stick, chocolate covered
turkey ham, sliced, extra lean, prepackaged or deli-sliced	ham, sliced, prepackaged (96% fat free, water added)
peppers, hot pickled, canned	peppers, hot chili, red, raw
beef, round, top round roast, boneless, separable lean and fat, trimmed to 0" fat, all grades, cooked, roasted	beef, round, tip round, roast, separable lean and fat, trimmed to 0" fat, all grades, cooked, roasted
salad dressing, mayonnaise-type, light	salad dressing, mayonnaise, light
frankfurter, meat and poultry, unheated	fruit cocktail, (peach and pineapple and pear and grape and cherry), canned, water pack, solids and liquids
bread, cinnamon	bread, white, commercially prepared (includes soft bread crumbs)
canadian bacon, cooked, pan-fried	pork, cured, bacon, cooked, pan-fried
cookies, brownies, commercially prepared, reduced fat, with added fiber	milk, chocolate, fluid, commercial, reduced fat, with added vitamin a and vitamin d
mayonnaise, reduced fat, with olive oil	margarine-like, vegetable oil spread, 60% fat, tub, with salt, with added vitamin d
kielbasa, fully cooked, grilled	beef, rib eye steak, boneless, lip-on, separable lean only, trimmed to 1/8" fat, all grades, cooked, grilled
beef, loin, top loin steak, boneless, lip off, separable lean only, trimmed to 0" fat, all grades, raw	beef, loin, top sirloin cap steak, boneless, separable lean and fat, trimmed to 1/8" fat, all grades, raw
bread, french or vienna, whole wheat	bread, wheat, white wheat
game meat, bison, separable lean only, cooked, roasted	game meat, deer, loin, separable lean only, 1" steak, cooked, broiled
fast foods, breakfast burrito, with egg, cheese, and sausage	fast foods, bagel, with breakfast steak, egg, cheese, and condiments
fast foods, submarine sandwich, turkey breast on white bread with lettuce and tomato	fast foods, grilled chicken filet sandwich, with lettuce, tomato and spread
macaroni or noodles with cheese, microwaveable, unprepared	macaroni and cheese dinner with dry sauce mix, boxed, uncooked
sweet potatoes, french fried, frozen as packaged, salt added in processing	potatoes, french fried, all types, salt added in processing, frozen, home-prepared, oven heated
turkey, all classes, light meat, cooked, roasted	beef, round, tip round, roast, separable lean and fat, trimmed to 0" fat, all grades, cooked, roasted
chicken, broilers or fryers, wing, meat and skin, cooked, roasted	fruit cocktail, (peach and pineapple and pear and grape and cherry), canned, water pack, solids and liquids
chicken, broilers or fryers, thigh, meat and skin, cooked, roasted	fruit cocktail, (peach and pineapple and pear and grape and cherry), canned, water pack, solids and liquids
chicken, broiler, rotisserie, bbq, thigh, meat and skin	fruit cocktail, (peach and pineapple and pear and grape and cherry), canned, water pack, solids and liquids
chicken, broiler, rotisserie, bbq, breast, meat and skin	fruit cocktail, (peach and pineapple and pear and grape and cherry), canned, water pack, solids and liquids
beverages, abbott, eas whey protein powder	protein supplement, milk based, muscle milk, powder
chicken, broilers or fryers, drumstick, meat and skin, cooked, roasted	fruit cocktail, (peach and pineapple and pear and grape and cherry), canned, water pack, solids and liquids
chicken, broilers or fryers, thigh, meat only, cooked, roasted	chicken, broiler or fryers, breast, skinless, boneless, meat only, cooked, braised
beverages, protein powder soy based	protein supplement, milk based, muscle milk, powder
chicken, broilers or fryers, dark meat, drumstick, meat only, cooked, roasted	chicken, broiler or fryers, breast, skinless, boneless, meat only, cooked, braised
chicken, broilers or fryers, dark meat, drumstick, meat and skin, cooked, braised	chicken, broiler or fryers, breast, skinless, boneless, meat only, cooked, braised
syrup, nestle, chocolate	cake, chocolate, commercially prepared with chocolate frosting, in-store bakery
chicken, broilers or fryers, dark meat, thigh, meat only, cooked, braised	chicken, broiler or fryers, breast, skinless, boneless, meat only, cooked, braised
chicken, broilers or fryers, drumstick, meat only, cooked, braised	chicken, broiler or fryers, breast, skinless, boneless, meat only, cooked, braised
beverages, tropical punch, ready-to-drink	sports drink, coca-cola, powerade, lemon-lime flavored, ready-to-drink
chicken, broilers or fryers, dark meat, thigh, meat and skin, cooked, braised	chicken, broiler or fryers, breast, skinless, boneless, meat only, cooked, braised
beverages, aloe vera juice drink, fortified with vitamin c	beverages, fruit juice drink, reduced sugar, with vitamin e added
chicken, broilers or fryers, thigh, meat and skin, raw	fruit cocktail, (peach and pineapple and pear and grape and cherry), canned, water pack, solids and liquids
beverages, whey protein powder isolate	protein supplement, milk based, muscle milk, powder
fast foods, fried chicken, thigh, meat and skin and breading	fruit cocktail, (peach and pineapple and pear and grape and cherry), canned, water pack, solids and liquids
bologna, meat and poultry	fruit cocktail, (peach and pineapple and pear and grape and cherry), canned, water pack, solids and liquids
fast foods, submarine sandwich, sweet onion chicken teriyaki on white bread with lettuce, tomato and sweet onion sauce	fast foods, grilled chicken filet sandwich, with lettuce, tomato and spread
crackers, water biscuits	cookies, animal crackers (includes arrowroot, tea biscuits)
lamb, rib, separable lean only, trimmed to 1/4" fat, choice, cooked, broiled	beef, rib, small end (ribs 10-12), separable lean only, trimmed to 1/8"fat, choice, cooked, broiled
beverages, rice milk, unsweetened	beverages, almond milk, unsweetened, shelf stable
beverages, tea, instant, decaffeinated, unsweetened	tea, black, brewed, prepared with tap water, decaffeinated
chicken, broilers or fryers, skin only, raw	chicken, broiler or fryers, breast, skinless, boneless, meat only, cooked, braised
beverages, tea, instant, lemon, diet	beverages, tea, hibiscus, brewed	beverages, tea, hibiscus, brewed
mango, dried, sweetened	cranberries, dried, sweetened
turkey, whole, neck, meat only, cooked, simmered	turkey, whole, meat only, raw
bread, roll, mexican, bollilo	bread, white, commercially prepared (includes soft bread crumbs)
dip, bean, original flavor	snacks, fritolay, sunchips, multigrain snack, original flavor
beverages, carbonated, cola, regular	carbonated beverage, low calorie, other than cola or pepper, with sodium saccharin, without caffeine
beverages, coffee, instant, mocha, sweetened	coffee, instant, regular, powder
roast beef, deli style, prepackaged, sliced	beef, round, bottom round, roast, separable lean only, trimmed to 1/8" fat, select, cooked, roasted
sausage, breakfast sausage, beef, pre-cooked, unprepared	sausage, pork and beef, with cheddar cheese, smoked
milk, chocolate, fat free, with added vitamin a and vitamin d	milk, chocolate, fluid, commercial, reduced fat, with added vitamin a and vitamin d
beverages, energy drink, monster, fortified with vitamins c, b2, b3, b6, b12	beverages, coconut milk, sweetened, fortified with calcium, vitamins a, b12, d2
beverages, energy drink, red bull	energy drink, red bull, sugar free, with added caffeine, niacin, pantothenic acid, vitamins b6 and b12
dip, salsa con queso, cheese and salsa- medium	fruit cocktail, (peach and pineapple and pear and grape and cherry), canned, water pack, solids and liquids
whey, sweet, dried	whey, sweet, dried
schiff,tiger's milk bar	protein supplement, milk based, muscle milk, powder
fast foods, fried chicken, breast, meat only, skin and breading removed	fruit cocktail, (peach and pineapple and pear and grape and cherry), canned, water pack, solids and liquids
fast foods, chicken, breaded and fried, boneless pieces, plain	fruit cocktail, (peach and pineapple and pear and grape and cherry), canned, water pack, solids and liquids
beverages, yellow green colored citrus soft drink with caffeine	energy drink, red bull, sugar free, with added caffeine, niacin, pantothenic acid, vitamins b6 and b12
sausage, egg and cheese breakfast biscuit	fast foods, griddle cake sandwich, egg, cheese, and sausage
taquitos, frozen, beef and cheese, oven-heated	fruit cocktail, (peach and pineapple and pear and grape and cherry), canned, water pack, solids and liquids
reduced sodium: chicken breast, deli, rotisserie seasoned, sliced, prepackaged	chicken, breast, boiled, sliced
beverages, coconut water, ready-to-drink, unsweetened	nuts, coconut water (liquid from coconuts)
fast foods, fried chicken, drumstick, meat only, skin and breading removed	fruit cocktail, (peach and pineapple and pear and grape and cherry), canned, water pack, solids and liquids
reduced sodium: ham, sliced, pre-packaged, deli meat (96%fat free, water added)	ham, sliced, prepackaged (96% fat free, water added)
fast foods, breadstick, soft, prepared with garlic and parmesan cheese	fast foods, taco with beef, cheese and lettuce, soft
cereals ready-to-eat, nature's path, organic flax plus, pumpkin granola	cereals ready-to-eat, nature's path, optimum
cookie, butter or sugar, with chocolate icing or filling	cookies, chocolate sandwich, with creme filling, regular
sauce, peanut, made from peanut butter, water, soy sauce	soy sauce made from soy and wheat (shoyu)
beverages, protein powder whey based	protein supplement, milk based, muscle milk, powder
beverages, the coca-cola company, nos energy drink, original, grape, loaded cherry, charged citrus, fortified with vitamins b6 and b12	fruit cocktail, (peach and pineapple and pear and grape and cherry), canned, water pack, solids and liquids
beverages, slimfast, meal replacement,  high protein shake, ready-to-drink, 3-2-1 plan	sports drink, coca-cola, powerade, lemon-lime flavored, ready-to-drink
alcoholic beverage, malt beer, hard lemonade	alcoholic beverage, beer, regular, all
candies, m&m mars pretzel chocolate candies	candies, mars snackfood us, m&m's peanut chocolate candies
bread, gluten-free, white, made with rice flour, corn starch, and/or tapioca	bread, cornbread, prepared from recipe, made with low fat (2%) milk
yellow rice with seasoning, dry packet mix, unprepared	gelatin desserts, dry mix, reduced calorie, with aspartame, prepared with water
cookie, with peanut butter filling, chocolate-coated	crackers, standard snack-type, sandwich, with peanut butter filling
lamb, loin, separable lean only, trimmed to 1/4" fat, choice, cooked, broiled	beef, short loin, top loin, steak, separable lean and fat, trimmed to 1/8" fat, choice, cooked, broiled
beverages, abbott, ensure, nutritional shake, ready-to-drink	sports drink, coca-cola, powerade, lemon-lime flavored, ready-to-drink
lamb, leg, whole (shank and sirloin), separable lean only, trimmed to 1/4" fat, choice, cooked, roasted	beef, short loin, top loin, steak, separable lean and fat, trimmed to 1/8" fat, choice, cooked, broiled
lamb, shoulder, whole (arm and blade), separable lean only, trimmed to 1/4" fat, choice, cooked, roasted	beef, chuck, arm pot roast, separable lean and fat, trimmed to 1/8" fat, choice, cooked, braised
candies, toblerone, milk chocolate with honey and almond nougat	fruit cocktail, (peach and pineapple and pear and grape and cherry), canned, water pack, solids and liquids
syrup, fruit flavored	fruit flavored drink containing less than 3% fruit juice, with high vitamin c
fast foods, fried chicken, thigh, meat only, skin and breading removed	fruit cocktail, (peach and pineapple and pear and grape and cherry), canned, water pack, solids and liquids
sweetener, herbal extract powder from stevia leaf	sweeteners, tabletop, fructose, dry, powder
potsticker or wonton, pork and vegetable, frozen, unprepared	fruit cocktail, (peach and pineapple and pear and grape and cherry), canned, water pack, solids and liquids
beverages, cytosport, muscle milk, ready-to-drink	protein supplement, milk based, muscle milk, powderus, brewed
pasta, whole-wheat, cooked (includes foods for usda's food distribution program)	cheese, cheddar (includes foods for usda's food distribution program)
beverages, tea, instant, lemon, sweetened, powder	beverage, instant breakfast powder, chocolate, not reconstituted
beverages, tea, instant, lemon, unsweetened	beverages, tea, hibiscus, brewed
beverages, tea, hibisc