nuts, coconut meat, dried (desiccated), sweetened, flaked, packaged	nuts, coconut meat, dried (desiccated), sweetened, flaked, packaged
guava sauce, cooked	guava sauce, cooked
candies, milk chocolate coated coffee beans	candies, milk chocolate coated coffee beans
veggie burgers or soyburgers, unprepared	veggie burgers or soyburgers, unprepared
chocolate-flavored hazelnut spread	chocolate-flavored hazelnut spread
cookies, brownies, commercially prepared	cookies, brownies, commercially prepared
frostings, chocolate, creamy, ready-to-eat	frostings, chocolate, creamy, ready-to-eat
beans, snap, green, canned, regular pack, drained solids	beans, snap, green, canned, regular pack, drained solids
beans, kidney, red, mature seeds, cooked, boiled, without salt	beans, kidney, red, mature seeds, cooked, boiled, without salt
wheat bran, crude	wheat bran, crude
beverages, fruit punch drink, frozen concentrate, prepared with water	beverages, fruit punch drink, frozen concentrate, prepared with water
pie fillings, cherry	pie fillings, cherry
cereals, oats, instant, fortified, with cinnamon and spice, prepared with water	cereals, oats, instant, fortified, with cinnamon and spice, prepared with water
nuts, pine nuts, dried	nuts, pine nuts, dried
oil, vegetable, corn, industrial and retail, all purpose salad or cooking	oil, corn, industrial and retail, all purpose salad or cooking
lamb, domestic, leg, shank half, separable lean and fat, trimmed to 1/4" fat, cooked, roasted	lamb, domestic, leg, shank half, separable lean and fat, trimmed to 1/4" fat, cooked, roasted
milk, reduced fat, fluid, 2% milkfat, with added vitamin a and vitamin d	milk, reduced fat, fluid, 2% milkfat, with added vitamin a and vitamin d
cheese, cottage, creamed, large or small curd	cheese, cottage, creamed, large or small curd
potatoes, red, flesh and skin, baked	potatoes, red, flesh and skin, baked
salad dressing, mayonnaise, regular	salad dressing, mayonnaise, regular
nuts, cashew nuts, oil roasted, with salt added	nuts, cashew nuts, oil roasted, with salt added
soy flour, defatted	soy flour, defatted
soy protein concentrate, produced by alcohol extraction	soy protein concentrate, produced by alcohol extraction
fruit cocktail, (peach and pineapple and pear and grape and cherry), canned, water pack, solids and liquids	fruit cocktail, (peach and pineapple and pear and grape and cherry), canned, water pack, solids and liquids
cereals ready-to-eat, kellogg, kellogg's corn flakes	cereals ready-to-eat, kellogg, kellogg's corn flakes
nuts, walnuts, english	nuts, walnuts, english
carrots, mature, raw	carrots, mature, raw
kale, cooked, boiled, drained, without salt	kale, cooked, boiled, drained, without salt
beef, chuck, shoulder clod, shoulder tender, medallion, separable lean and fat, trimmed to 0" fat, cooked, grilled	beef, chuck, shoulder clod, shoulder tender, medallion, separable lean and fat, trimmed to 0" fat, cooked, grilled
sauce, teriyaki, ready-to-serve	sauce, teriyaki, ready-to-serve
chicken, broilers or fryers, breast, meat only, cooked, roasted	chicken, broilers or fryers, breast, meat only, cooked, roasted
grapes, red or green (european type, such as thompson seedless), raw	grapes, red or green (european type, such as thompson seedless), raw
potatoes, hash brown, home-prepared	potatoes, hash brown, home-prepared
fish, salmon, pink, cooked, dry heat	fish, salmon, pink, cooked, dry heat
tea, instant, unsweetened, powder	tea, instant, unsweetened, powder
doughnuts, cake-type, plain (includes unsugared, old-fashioned)	doughnuts, cake-type, plain (includes unsugared, old-fashioned)
oil, vegetable, safflower, salad or cooking, high oleic (primary safflower oil of commerce)	oil, safflower, salad or cooking, high oleic (primary safflower oil of commerce)
cheese, pasteurized process, american, fortified with vitamin d	cheese, pasteurized process, american, fortified with vitamin d
radishes, raw	radishes, raw
pork, fresh, loin, top loin (chops), boneless, separable lean only, cooked, pan-broiled	pork, fresh, loin, top loin (chops), boneless, separable lean only, cooked, pan-broiled
nuts, chestnuts, european, boiled and steamed	nuts, chestnuts, european, boiled and steamed
beans, black turtle, mature seeds, cooked, boiled, without salt	beans, black turtle, mature seeds, cooked, boiled, without salt
peppers, sweet, green, cooked, boiled, drained, without salt	peppers, sweet, green, cooked, boiled, drained, without salt
beef, top sirloin, steak, separable lean only, trimmed to 0" fat, select, cooked, broiled	beef, top sirloin, steak, separable lean only, trimmed to 0" fat, select, cooked, broiled
chicken, broilers or fryers, thigh, meat only, cooked, roasted	chicken, broilers or fryers, thigh, meat only, cooked, roasted
pork, fresh, loin, top loin (roasts), boneless, separable lean only, cooked, roasted	pork, fresh, loin, top loin (roasts), boneless, separable lean only, cooked, roasted
cake, angelfood, commercially prepared	cake, angelfood, commercially prepared
soup, chicken noodle, canned, prepared with equal volume water	soup, chicken noodle, canned, prepared with equal volume water
sauce, worcestershire	sauce, worcestershire
seeds, sunflower seed kernels, oil roasted, with salt added	seeds, sunflower seed kernels, oil roasted, with salt added
beef, ground, 85% lean meat / 15% fat, patty, cooked, broiled	beef, ground, 85% lean meat / 15% fat, patty, cooked, broiled
coffee, instant, regular, powder	coffee, instant, regular, powder
sweet potato, cooked, baked in skin, flesh, without salt	sweet potato, cooked, baked in skin, flesh, without salt
cookies, chocolate chip, commercially prepared, regular, higher fat, enriched	cookies, chocolate chip, commercially prepared, regular, higher fat, enriched
turnip greens, cooked, boiled, drained, without salt	turnip greens, cooked, boiled, drained, without salt
turkey, all classes, breast, meat only, cooked, roasted	turkey, all classes, breast, meat only, cooked, roasted
corn, sweet, yellow, cooked, boiled, drained, without salt	corn, sweet, yellow, cooked, boiled, drained, without salt
lettuce, green leaf, raw	lettuce, green leaf, raw
seeds, pumpkin and squash seed kernels, roasted, with salt added	seeds, pumpkin and squash seed kernels, roasted, with salt added
fish, tuna, fresh, yellowfin, cooked, dry heat	fish, tuna, fresh, yellowfin, cooked, dry heat
apples, raw, with skin (includes usda commodity food a343)	apples, raw, with skin (includes usda commodity food a343)
beef, round, bottom round, steak, separable lean only, trimmed to 0" fat, all grades, cooked, braised	beef, round, bottom round, steak, separable lean only, trimmed to 0" fat, all grades, cooked, braised
potatoes, baked, flesh and skin, without salt	potatoes, baked, flesh and skin, without salt
cheese, swiss	cheese, swiss
celery, cooked, boiled, drained, without salt	celery, cooked, boiled, drained, without salt
oil, vegetable, soybean, salad or cooking	oil, soybean, salad or cooking
peas, green, cooked, boiled, drained, without salt	peas, green, cooked, boiled, drained, without salt
fish, cod, atlantic, cooked, dry heat	fish, cod, atlantic, cooked, dry heat
yogurt, plain, whole milk	yogurt, plain, whole milk
beverages, coffee, brewed, prepared with tap water	beverages, coffee, brewed, prepared with tap water
cheese, cheddar	cheese, cheddar
egg, whole, cooked, hard-boiled	egg, whole, cooked, hard-boiled
cereals ready-to-eat, post, honey bunches of oats, honey roasted	cereals ready-to-eat, post, honey bunches of oats, honey roasted
nuts, hazelnuts or filberts	nuts, hazelnuts or filberts
chicken, broilers or fryers, leg, meat only, cooked, roasted	chicken, broilers or fryers, leg, meat only, cooked, roasted
mustard, prepared, yellow	mustard, prepared, yellow
pork, fresh, shoulder, arm picnic, separable lean only, cooked, braised	pork, fresh, shoulder, arm picnic, separable lean only, cooked, braised
beets, cooked, boiled, drained	beets, cooked, boiled, drained
soup, vegetable beef, canned, prepared with equal volume water	soup, vegetable beef, canned, prepared with equal volume water
fish, halibut, atlantic and pacific, cooked, dry heat	fish, halibut, atlantic and pacific, cooked, dry heat
broccoli, cooked, boiled, drained, without salt	broccoli, cooked, boiled, drained, without salt
ice creams, vanilla	ice creams, vanilla
beans, pinto, mature seeds, cooked, boiled, without salt	beans, pinto, mature seeds, cooked, boiled, without salt
spices, paprika	spices, paprika
salad dressing, thousand island, commercial, regular	salad dressing, thousand island, commercial, regular
oil, vegetable, canola	oil, canola
fish, flounder, cooked, dry heat	fish, flounder, cooked, dry heat
rice, brown, long-grain, cooked	rice, brown, long-grain, cooked
cereals ready-to-eat, kellogg, kellogg's raisin bran	cereals ready-to-eat, kellogg, kellogg's raisin bran
squash, summer, crookneck and straightneck, cooked, boiled, drained, without salt	squash, summer, crookneck and straightneck, cooked, boiled, drained, without salt
bread, white, commercially prepared (includes soft bread crumbs)	bread, white, commercially prepared (includes soft bread crumbs)
fish, trout, rainbow, farmed, cooked, dry heat	fish, trout, rainbow, farmed, cooked, dry heat
tomatoes, red, ripe, cooked, stewed	tomatoes, red, ripe, cooked, stewed
tofu, raw, firm, prepared with calcium sulfate	tofu, raw, firm, prepared with calcium sulfate
beef, round, eye of round, separable lean only, trimmed to 0" fat, choice, cooked, roasted	beef, round, eye of round, separable lean only, trimmed to 0" fat, choice, cooked, roasted
cauliflower, cooked, boiled, drained, without salt	cauliflower, cooked, boiled, drained, without salt
asparagus, cooked, boiled, drained	asparagus, cooked, boiled, drained
spinach, cooked, boiled, drained, without salt	spinach, cooked, boiled, drained, without salt
fish, catfish, channel, cooked, breaded and fried	fish, catfish, channel, cooked, breaded and fried
turkey, all classes, thigh, meat only, cooked, roasted	turkey, all classes, thigh, meat only, cooked, roasted
oil, vegetable, cottonseed, salad or cooking	oil, cottonseed, salad or cooking
crackers, saltines (includes oyster, soda, soup)	crackers, saltines (includes oyster, soda, soup)
pork, fresh, loin, center loin (chops), bone-in, separable lean only, cooked, broiled	pork, fresh, loin, center loin (chops), bone-in, separable lean only, cooked, broiled
mushrooms, white, cooked, boiled, drained, without salt	mushrooms, white, cooked, boiled, drained, without salt
chicken, broilers or fryers, wing, meat only, cooked, roasted	chicken, broilers or fryers, wing, meat only, cooked, roasted
nuts, brazil nuts, dried, unblanched	nuts, brazil nuts, dried, unblanched
lima beans, immature seeds, cooked, boiled, drained, without salt	lima beans, immature seeds, cooked, boiled, drained, without salt
soup, tomato, canned, prepared with equal volume water	soup, tomato, canned, prepared with equal volume water
beef, chuck, arm pot roast, separable lean only, trimmed to 0" fat, choice, cooked, braised	beef, chuck, arm pot roast, separable lean only, trimmed to 0" fat, choice, cooked, braised
fish, mackerel, atlantic, cooked, dry heat	fish, mackerel, atlantic, cooked, dry heat
brussels sprouts, cooked, boiled, drained, without salt	brussels sprouts, cooked, boiled, drained, without salt
rice, white, long-grain, regular, cooked	rice, white, long-grain, regular, cooked
okra, cooked, boiled, drained, without salt	okra, cooked, boiled, drained, without salt
beef, rib, large end (ribs 6-9), separable lean only, trimmed to 0" fat, choice, cooked, broiled	beef, rib, large end (ribs 6-9), separable lean only, trimmed to 0" fat, choice, cooked, broiled
fish, sardine, atlantic, canned in oil, drained solids with bone	fish, sardine, atlantic, canned in oil, drained solids with bone
cabbage, cooked, boiled, drained, without salt	cabbage, cooked, boiled, drained, without salt
nuts, pecans	nuts, pecans
fish, salmon, atlantic, farmed, cooked, dry heat	fish, salmon, atlantic, farmed, cooked, dry heat
onions, cooked, boiled, drained, without salt	onions, cooked, boiled, drained, without salt
chicken, broilers or fryers, drumstick, meat only, cooked, roasted	chicken, broilers or fryers, drumstick, meat only, cooked, roasted
beverages, carbonated, cola, without caffeine	beverages, carbonated, cola, without caffeine
collards, cooked, boiled, drained, without salt	collards, cooked, boiled, drained, without salt
beef, tenderloin, steak, separable lean only, trimmed to 0" fat, choice, cooked, broiled	beef, tenderloin, steak, separable lean only, trimmed to 0" fat, choice, cooked, broiled
nuts, almonds	nuts, almonds
fish, pollock, walleye, cooked, dry heat	fish, pollock, walleye, cooked, dry heat
leeks, (bulb and lower leaf-portion), cooked, boiled, drained, without salt	leeks, (bulb and lower leaf-portion), cooked, boiled, drained, without salt
artichokes, (globe or french), cooked, boiled, drained, without salt	artichokes, (globe or french), cooked, boiled, drained, without salt
rice, white, medium-grain, cooked	rice, white, medium-grain, cooked
lamb, domestic, shoulder, arm, separable lean only, trimmed to 1/4" fat, choice, cooked, roasted	lamb, domestic, shoulder, arm, separable lean only, trimmed to 1/4" fat, choice, cooked, roasted
cheese, mozzarella, whole milk	cheese, mozzarella, whole milk
turnips, cooked, boiled, drained, without salt	turnips, cooked, boiled, drained, without salt
veal, leg (top round), separable lean only, cooked, braised	veal, leg (top round), separable lean only, cooked, braised
fish, rockfish, pacific, mixed species, cooked, dry heat	fish, rockfish, pacific, mixed species, cooked, dry heat
parsnips, cooked, boiled, drained, without salt	parsnips, cooked, boiled, drained, without salt
beef, flank, steak, separable lean only, trimmed to 0" fat, choice, cooked, broiled	beef, flank, steak, separable lean only, trimmed to 0" fat, choice, cooked, broiled
rutabagas, cooked, boiled, drained, without salt	rutabagas, cooked, boiled, drained, without salt
lamb, domestic, loin, separable lean only, trimmed to 1/4" fat, choice, cooked, broiled	lamb, domestic, loin, separable lean only, trimmed to 1/4" fat, choice, cooked, broiled
beef, short loin, porterhouse steak, separable lean only, trimmed to 0" fat, choice, cooked, broiled	beef, short loin, porterhouse steak, separable lean only, trimmed to 0" fat, choice, cooked, broiled
beverages, tea, black, brewed, prepared with tap water	beverages, tea, black, brewed, prepared with tap water
cheese, ricotta, whole milk	cheese, ricotta, whole milk
pork, fresh, loin, center rib (roasts), bone-in, separable lean only, cooked, roasted	pork, fresh, loin, center rib (roasts), bone-in, separable lean only, cooked, roasted
fish, bass, striped, cooked, dry heat	fish, bass, striped, cooked, dry heat
goose, domesticated, meat only, cooked, roasted	goose, domesticated, meat only, cooked, roasted
duck, domesticated, meat only, cooked, roasted	duck, domesticated, meat only, cooked, roasted
veal, shoulder, arm, separable lean only, cooked, braised	veal, shoulder, arm, separable lean only, cooked, braised
beef, short loin, t-bone steak, separable lean only, trimmed to 0" fat, choice, cooked, broiled	beef, short loin, t-bone steak, separable lean only, trimmed to 0" fat, choice, cooked, broiled
pork, fresh, shoulder, whole, separable lean only, cooked, roasted	pork, fresh, shoulder, whole, separable lean only, cooked, roasted
fish, snapper, mixed species, cooked, dry heat	fish, snapper, mixed species, cooked, dry heat
lamb, domestic, rib, separable lean only, trimmed to 1/4" fat, choice, cooked, broiled	lamb, domestic, rib, separable lean only, trimmed to 1/4" fat, choice, cooked, broiled
beef, round, top round, separable lean only, trimmed to 0" fat, choice, cooked, broiled	beef, round, top round, separable lean only, trimmed to 0" fat, choice, cooked, broiled
fish, salmon, chinook, cooked, dry heat	fish, salmon, chinook, cooked, dry heat
veal, loin, separable lean only, cooked, braised	veal, loin, separable lean only, cooked, braised
fish, grouper, mixed species, cooked, dry heat	fish, grouper, mixed species, cooked, dry heat
pork, fresh, leg (ham), whole, separable lean only, cooked, roasted	pork, fresh, leg (ham), whole, separable lean only, cooked, roasted
beef, round, tip round, separable lean only, trimmed to 0" fat, choice, cooked, roasted	beef, round, tip round, separable lean only, trimmed to 0" fat, choice, cooked, roasted
fish, swordfish, cooked, dry heat	fish, swordfish, cooked, dry heat
lamb, domestic, foreshank, separable lean only, trimmed to 1/4" fat, choice, cooked, braised	lamb, domestic, foreshank, separable lean only, trimmed to 1/4" fat, choice, cooked, braised
fish, ocean perch, atlantic, cooked, dry heat	fish, ocean perch, atlantic, cooked, dry heat
veal, rib, separable lean only, cooked, braised	veal, rib, separable lean only, cooked, braised
turkey, all classes, leg, meat only, cooked, roasted	turkey, all classes, leg, meat only, cooked, roasted
game meat, rabbit, domesticated, composite of cuts, cooked, roasted	game meat, rabbit, domesticated, composite of cuts, cooked, roasted
fish, pike, northern, cooked, dry heat	fish, pike, northern, cooked, dry heat
pork, cured, ham, boneless, extra lean (approximately 5% fat), roasted	pork, cured, ham, boneless, extra lean (approximately 5% fat), roasted
beef, brisket, flat half, separable lean only, trimmed to 0" fat, choice, cooked, braised	beef, brisket, flat half, separable lean only, trimmed to 0" fat, choice, cooked, braised
game meat, venison, cooked, roasted	game meat, venison, cooked, roasted
fish, whiting, mixed species, cooked, dry heat	fish, whiting, mixed species, cooked, dry heat
turkey, all classes, wing, meat only, cooked, roasted	turkey, all classes, wing, meat only, cooked, roasted
turkey, all classes, back, meat only, cooked, roasted	turkey, all classes, back, meat only, cooked, roasted
game meat, elk, cooked, roasted	game meat, elk, cooked, roasted
fish, mahi-mahi, cooked, dry heat	fish, mahi-mahi, cooked, dry heat
cheese, goat, soft type	cheese, goat, soft type
fish, sea bass, mixed species, cooked, dry heat	fish, sea bass, mixed species, cooked, dry heat
crustaceans, lobster, northern, cooked, moist heat	crustaceans, lobster, northern, cooked, moist heat
mollusks, oyster, eastern, cooked, breaded and fried	mollusks, oyster, eastern, cooked, breaded and fried
crustaceans, crab, alaska king, cooked, moist heat	crustaceans, crab, alaska king, cooked, moist heat
fish, pompano, florida, cooked, dry heat	fish, pompano, florida, cooked, dry heat
crustaceans, shrimp, mixed species, cooked, moist heat	crustaceans, shrimp, mixed species, cooked, moist heat
mollusks, clam, mixed species, cooked, moist heat	mollusks, clam, mixed species, cooked, moist heat
fish, monkfish, cooked, dry heat	fish, monkfish, cooked, dry heat
mollusks, scallop, mixed species, cooked, breaded and fried	mollusks, scallop, mixed species, cooked, breaded and fried
crustaceans, crab, blue, cooked, moist heat	crustaceans, crab, blue, cooked, moist heat
fish, croaker, atlantic, cooked, breaded and fried	fish, croaker, atlantic, cooked, breaded and fried
crustaceans, crayfish, mixed species, farmed, cooked, moist heat	crustaceans, crayfish, mixed species, farmed, cooked, moist heat
mollusks, mussel, blue, cooked, moist heat	mollusks, mussel, blue, cooked, moist heat
crustaceans, spiny lobster, mixed species, cooked, moist heat	crustaceans, spiny lobster, mixed species, cooked, moist heat
fish, tilefish, cooked, dry heat	fish, tilefish, cooked, dry heat
fish, spot, cooked, dry heat	fish, spot, cooked, dry heat
mollusks, abalone, mixed species, cooked, fried	mollusks, abalone, mixed species, cooked, fried
mollusks, conch, baked or broiled	mollusks, conch, baked or broiled
mollusks, whelk, unspecified, cooked, moist heat	mollusks, whelk, unspecified, cooked, moist heat
fish, bluefish, cooked, dry heat	fish, bluefish, cooked, dry heat
crustaceans, crab, dungeness, cooked, moist heat	crustaceans, crab, dungeness, cooked, moist heat
fish, drum, freshwater, cooked, dry heat	fish, drum, freshwater, cooked, dry heat
fish, lingcod, cooked, dry heat	fish, lingcod, cooked, dry heat
game meat, bison, cooked, roasted	game meat, bison, cooked, roasted
game meat, boar, wild, cooked, roasted	game meat, boar, wild, cooked, roasted
game meat, caribou, cooked, roasted	game meat, caribou, cooked, roasted
game meat, deer, cooked, roasted	game meat, deer, cooked, roasted
game meat, moose, cooked, roasted	game meat, moose, cooked, roasted
fish, eel, mixed species, cooked, dry heat	fish, eel, mixed species, cooked, dry heat
fish, sturgeon, mixed species, cooked, dry heat	fish, sturgeon, mixed species, cooked, dry heat
fish, sucker, white, cooked, dry heat	fish, sucker, white, cooked, dry heart
fish, mullet, striped, cooked, dry heat	fish, mullet, striped, cooked, dry heat
fish, cisco, smoked	fish, cisco, smoked
fish, burbot, cooked, dry heat	fish, burbot, cooked, dry heat
fish, buffalo, black, cooked, dry heat	fish, buffalo, black, cooked, dry heat
fish, carp, cooked, dry heat	fish, carp, cooked, dry heat
fish, smelt, rainbow, cooked, dry heat	fish, smelt, rainbow, cooked, dry heat
fish, sheepshead, cooked, dry heat	fish, sheepshead, cooked, dry heat
game meat, squirrel, cooked, roasted	game meat, squirrel, cooked, roasted
game meat, opossum, cooked, roasted
beverages, chocolate-flavored drink, whey and milk based	beverages, chocolate-flavored drink, whey and milk based
syrups, sugar free	syrups, sugar free
baking chocolate, unsweetened, squares	baking chocolate, unsweetened, squares
candies, caramels	candies, caramels
candies, fondant, prepared-from-recipe	candies, fondant, prepared-from-recipe
peanuts, all types, oil-roasted, with salt	peanuts, all types, oil-roasted, with salt
spices, thyme, dried	spices, thyme, dried
fast food, pizza chain, 14" pizza, pepperoni topping, thick crust	fast food, pizza chain, 14" pizza, pepperoni topping, thick crust
candies, rolo caramels in milk chocolate	candies, rolo caramels in milk chocolate
snacks, granola bar, quaker, chewy, 90 calorie bar	snacks, granola bar, quaker, chewy, 90 calorie bar
breakfast bar, corn flake crust with fruit	breakfast bar, corn flake crust with fruit
granola bar, soft, milk chocolate coated, peanut butter	granola bar, soft, milk chocolate coated, peanut butter
beverages, energy drink, red bull, sugar free, with added caffeine, niacin, pantothenic acid, vitamins b6 and b12	beverages, energy drink, red bull, sugar free, with added caffeine, niacin, pantothenic acid, vitamins b6 and b12
cereals ready-to-eat, post, grape-nuts flakes	cereals ready-to-eat, post, grape-nuts flakes
cereals ready-to-eat, post bran flakes	cereals ready-to-eat, post bran flakes
salad dressing, mayonnaise-like, fat-free	salad dressing, mayonnaise-like, fat-free
plums, dried (prunes), uncooked	plums, dried (prunes), uncooked
pork, fresh, composite of trimmed retail cuts (leg, loin, and shoulder), separable lean only, cooked	pork, fresh, composite of trimmed retail cuts (leg, loin, and shoulder), separable lean only, cooked
veal, sirloin, separable lean and fat, raw	veal, sirloin, separable lean and fat, raw
pork, cured, ham, whole, separable lean only, roasted	pork, cured, ham, whole, separable lean only, roasted
nuts, macadamia nuts, dry roasted, with salt added	nuts, macadamia nuts, dry roasted, with salt added
imitation cheese, american or cheddar, low cholesterol	imitation cheese, american or cheddar, low cholesterol
cabbage, chinese (pak-choi), raw	cabbage, chinese (pak-choi), raw
potatoes, french fried, all types, salt added in processing, frozen, home-prepared, oven heated	potatoes, french fried, all types, salt added in processing, frozen, home-prepared, oven heated
cereals, cream of wheat, instant, dry	cereals, cream of wheat, instant, dry
parmesan cheese topping, fat free	parmesan cheese topping, fat free
apricots, raw	apricots, raw
frozen novelties, no sugar added, fudgsicle pops	frozen novelties, no sugar added, fudgsicle pops
snacks, granola bar, general mills, nature valley, chewy trail mix	snacks, granola bar, general mills, nature valley, chewy trail mix
orange juice, chilled, includes from concentrate, with added calcium	orange juice, chilled, includes from concentrate, with added calcium
orange juice, chilled, includes from concentrate, with added calcium and vitamin d	orange juice, chilled, includes from concentrate, with added calcium and vitamin d
fruit cocktail, (peach and pineapple and pear and grape and cherry), canned, water pack, solids and liquids	fruit cocktail, (peach and pineapple and pear and grape and cherry), canned, water pack, solids and liquids
apple juice, frozen concentrate, unsweetened, undiluted, without added ascorbic acid	apple juice, frozen concentrate, unsweetened, undiluted, without added ascorbic acid
apple juice, canned or bottled, unsweetened, with added ascorbic acid	apple juice, canned or bottled, unsweetened, with added ascorbic acid
bread, stuffing, dry mix	bread, stuffing, dry mix
bologna, beef	bologna, beef
cookies, chocolate chip, commercially prepared, regular, lower fat	cookies, chocolate chip, commercially prepared, regular, lower fat
beef, rib, shortribs, separable lean and fat, choice, cooked, braised	beef, rib, shortribs, separable lean and fat, choice, cooked, braised
peas, green (includes baby and lesuer types), canned, drained solids, unprepared	peas, green (includes baby and lesuer types), canned, drained solids, unprepared
cream, half and half, fat free	cream, half and half, fat freed, roasted	game meat, opossum, cooke