cereals ready-to-eat, general mills, cheerios	cereals ready-to-eat, general mills, cheerios
crustaceans, shrimp, mixed species, raw (may contain additives to retain moisture)	crustaceans, shrimp, mixed species, raw
fish, tuna, light, canned in water, drained solids	fish, tuna, light, canned in water, drained solids
pickle relish, sweet	pickle relish, sweet
peas, green, frozen, cooked, boiled, drained, without salt	peas, green, frozen, cooked, boiled, drained, without salt
snacks, corn-based, extruded, chips, plain	snacks, corn-based, extruded, chips, plain
beans, snap, green, frozen, cooked, boiled, drained, without salt	beans, snap, green, frozen, cooked, boiled, drained, without salt
beef, round, top round, separable lean only, trimmed to 1/8" fat, choice, cooked, braised	beef, round, top round, separable lean only, trimmed to 1/8" fat, choice, cooked, braised
cereals ready-to-eat, kellogg, kellogg's corn flakes	cereals ready-to-eat, kellogg, kellogg's corn flakes
oil, vegetable, sunflower, linoleic, (partially hydrogenated)	oil, vegetable, sunflower, linoleic, (partially hydrogenated)
beverages, carbonated, cola, regular	beverages, carbonated, cola, regular
fish, salmon, atlantic, farmed, cooked, dry heat	fish, salmon, atlantic, farmed, cooked, dry heat
poultry, chicken, broilers or fryers, breast, meat only, cooked, roasted	poultry, chicken, broilers or fryers, breast, meat only, cooked, roasted
candies, milk chocolate	candies, milk chocolate
nuts, almonds	nuts, almonds
fast foods, hamburger; single, regular patty; plain	fast foods, hamburger; single, regular patty; plain
beverages, fruit juice drink, reduced calorie, with vitamin c added	beverages, fruit juice drink, reduced calorie, with vitamin c added
cheese, cheddar	cheese, cheddar
eggs, whole, raw, fresh	eggs, whole, raw, fresh
bread, white, commercially prepared (includes soft bread crumbs)	bread, white, commercially prepared (includes soft bread crumbs)
potatoes, russet, flesh and skin, raw	potatoes, russet, flesh and skin, raw
milk, reduced fat, fluid, 2% milkfat, with added vitamin a and vitamin d	milk, reduced fat, fluid, 2% milkfat, with added vitamin a and vitamin d
rice, white, long-grain, regular, cooked	rice, white, long-grain, regular, cooked
apples, raw, with skin (includes usda commodity food a343)	apples, raw, with skin (includes usda commodity food a343)
tomatoes, red, ripe, raw, year round average	tomatoes, red, ripe, raw, year round average
bananas, raw	bananas, raw
carrots, raw	carrots, raw
onions, raw	onions, raw
lettuce, iceberg (includes crisphead types), raw	lettuce, iceberg (includes crisphead types), raw
orange juice, raw (includes foods for usda's food distribution program)	orange juice, raw (includes foods for usda's food distribution program)
pasta, cooked, unenriched, without added salt	pasta, cooked, unenriched, without added salt
ground turkey, 93% lean, 7% fat, pan-broiled crumbles	ground turkey, 93% lean, 7% fat, pan-broiled crumbles
cereals ready-to-eat, general mills, honey nut cheerios	cereals ready-to-eat, general mills, honey nut cheerios
yogurt, plain, whole milk	yogurt, plain, whole milk
beef, ground, 85% lean meat / 15% fat, crumbles, cooked, pan-browned	beef, ground, 85% lean meat / 15% fat, crumbles, cooked, pan-browned
broccoli, raw	broccoli, raw
spinach, raw	spinach, raw
sweet potato, raw, unprepared (includes usda commodity food a230)	sweet potato, raw, unprepared (includes usda commodity food a230)
corn, sweet, yellow, cooked, boiled, drained, without salt	corn, sweet, yellow, cooked, boiled, drained, without salt
mushrooms, white, raw	mushrooms, white, raw
peppers, sweet, red, raw	peppers, sweet, red, raw
cauliflower, raw	cauliflower, raw
celery, raw	celery, raw
cucumber, with peel, raw	cucumber, with peel, raw
grapes, red or green (european type, such as thompson seedless), raw	grapes, red or green (european type, such as thompson seedless), raw
strawberries, raw	strawberries, raw
blueberries, raw	blueberries, raw
oranges, raw, all commercial varieties	oranges, raw, all commercial varieties
peaches, raw	peaches, raw
pears, raw	pears, raw
watermelon, raw	watermelon, raw
cantaloupe, raw	cantaloupe, raw
pineapple, raw, all varieties	pineapple, raw, all varieties
kiwifruit, green, raw	kiwifruit, green, raw
mangos, raw	mangos, raw
avocados, raw, all commercial varieties	avocados, raw, all commercial varieties
lemons, raw, without peel	lemons, raw, without peel
limes, raw	limes, raw
grapefruit, raw, pink and red, all areas	grapefruit, raw, pink and red, all areas
cherries, sweet, raw	cherries, sweet, raw
plums, raw	plums, raw
nectarines, raw	nectarines, raw
apricots, raw	apricots, raw
cranberries, raw	cranberries, raw
raspberries, raw	raspberries, raw
blackberries, raw	blackberries, raw
pomegranate, raw	pomegranate, raw
papaya, raw	papaya, raw
figs, raw	figs, raw
dates, deglet noor	dates, deglet noor
raisins, seedless	raisins, seedless
prunes, dehydrated (low-moisture), uncooked	prunes, dehydrated (low-moisture), uncooked
nuts, walnuts, english	nuts, walnuts, english
nuts, pecans	nuts, pecans
nuts, cashew nuts, raw	nuts, cashew nuts, raw
nuts, pistachios, raw	nuts, pistachios, raw
nuts, hazelnuts or filberts	nuts, hazelnuts or filberts
nuts, brazil nuts, dried, unblanched	nuts, brazil nuts, dried, unblanched
nuts, macadamia nuts, raw	nuts, macadamia nuts, raw
seeds, sunflower seed kernels, dried	seeds, sunflower seed kernels, dried
seeds, pumpkin and squash seed kernels, roasted, without salt	seeds, pumpkin and squash seed kernels, roasted, without salt
seeds, sesame seeds, whole, dried	seeds, sesame seeds, whole, dried
seeds, flaxseed	seeds, flaxseed
seeds, chia seeds, dried	seeds, chia seeds, dried
beans, black, mature seeds, cooked, boiled, without salt	beans, black, mature seeds, cooked, boiled, without salt
beans, pinto, mature seeds, cooked, boiled, without salt	beans, pinto, mature seeds, cooked, boiled, without salt
beans, kidney, red, mature seeds, cooked, boiled, without salt	beans, kidney, red, mature seeds, cooked, boiled, without salt
beans, navy, mature seeds, cooked, boiled, without salt	beans, navy, mature seeds, cooked, boiled, without salt
lentils, mature seeds, cooked, boiled, without salt	lentils, mature seeds, cooked, boiled, without salt
chickpeas (garbanzo beans, bengal gram), mature seeds, cooked, boiled, without salt	chickpeas (garbanzo beans, bengal gram), mature seeds, cooked, boiled, without salt
soybeans, mature seeds, cooked, boiled, without salt	soybeans, mature seeds, cooked, boiled, without salt
lima beans, large, mature seeds, cooked, boiled, without salt	lima beans, large, mature seeds, cooked, boiled, without salt
split peas, mature seeds, cooked, boiled, without salt	split peas, mature seeds, cooked, boiled, without salt
tofu, raw, regular, prepared with calcium sulfate	tofu, raw, regular, prepared with calcium sulfate
tempeh	tempeh
quinoa, cooked	quinoa, cooked
oats, regular and quick and instant, not fortified, dry	oats, regular and quick and instant, not fortified, dry
barley, hulled	barley, hulled
buckwheat	buckwheat
millet, cooked	millet, cooked
amaranth, cooked	amaranth, cooked
bulgur, cooked	bulgur, cooked
wild rice, cooked	wild rice, cooked
brown rice, long-grain, cooked (includes foods for usda's food distribution program)	brown rice, long-grain, cooked (includes foods for usda's food distribution program)
popcorn, air-popped	popcorn, air-popped
crackers, saltines (includes oyster, soda, soup)	crackers, saltines (includes oyster, soda, soup)
crackers, whole-wheat	crackers, whole-wheat
pretzels, hard, plain, salted	pretzels, hard, plain, salted
tortillas, ready-to-bake or -fry, corn	tortillas, ready-to-bake or -fry, corn
tortillas, ready-to-bake or -fry, flour, shelf stable	tortillas, ready-to-bake or -fry, flour, shelf stable
bread, whole-wheat, commercially prepared	bread, whole-wheat, commercially prepared
bread, rye	bread, rye
muffins, blueberry, commercially prepared (includes mini-muffins)	muffins, blueberry, commercially prepared (includes mini-muffins)
bagels, plain, enriched, with calcium propionate (includes onion, poppy, sesame)	bagels, plain, enriched, with calcium propionate (includes onion, poppy, sesame)
english muffins, plain, enriched, with ca prop (includes sourdough)	english muffins, plain, enriched, with ca prop (includes sourdough)
rolls, hamburger or hotdog, plain	rolls, hamburger or hotdog, plain
croissants, butter	croissants, butter
cookies, chocolate chip, commercially prepared, regular, higher fat, enriched	cookies, chocolate chip, commercially prepared, regular, higher fat, enriched
cookies, oatmeal, commercially prepared, regular	cookies, oatmeal, commercially prepared, regular
cookies, sugar, commercially prepared, regular (includes vanilla)	cookies, sugar, commercially prepared, regular (includes vanilla)
cake, chocolate, prepared from recipe without frosting	cake, chocolate, prepared from recipe without frosting
cake, yellow, prepared from recipe without frosting	cake, yellow, prepared from recipe without frosting
pie, apple, commercially prepared, enriched flour	pie, apple, commercially prepared, enriched flour
pie, pumpkin, commercially prepared	pie, pumpkin, commercially prepared
ice cream, vanilla	ice cream, vanilla
ice cream, chocolate	ice cream, chocolate
frozen yogurt, vanilla, soft-serve	frozen yogurt, vanilla, soft-serve
sherbet, orange	sherbet, orange
pudding, chocolate, ready-to-eat	pudding, chocolate, ready-to-eat
pudding, vanilla, ready-to-eat	pudding, vanilla, ready-to-eat
jams and preserves	jams and preserves
honey	honey
syrup, maple	syrup, maple
sugar, granulated	sugar, granulated
sugar, brown	sugar, brown
molasses	molasses
chocolate, dark, 70-85% cacao solids	chocolate, dark, 70-85% cacao solids
chocolate, milk	chocolate, milk
cocoa, dry powder, unsweetened	cocoa, dry powder, unsweetened
coffee, brewed from grounds, prepared with tap water	coffee, brewed from grounds, prepared with tap water
tea, brewed, prepared with tap water	tea, brewed, prepared with tap water
soft drink, cola, regular	soft drink, cola, regular
soft drink, lemon-lime soda, regular	soft drink, lemon-lime soda, regular
energy drinks, red bull	energy drinks, red bull
sports drinks, fluid replacement, electrolyte solution	sports drinks, fluid replacement, electrolyte solution
wine, red	wine, red
wine, white	wine, white
beer, regular, budweiser	beer, regular, budweiser
whiskey	whiskey
vodka	vodka
rum	rum
gin	gin
brandy	brandy
tequila	tequila
liqueur, coffee, 53 proof	liqueur, coffee, 53 proof
vinegar, cider	vinegar, cider
vinegar, balsamic	vinegar, balsamic
mustard, prepared, yellow	mustard, prepared, yellow
ketchup	ketchup
mayonnaise, regular	mayonnaise, regular
salad dressing, ranch dressing, commercial, regular	salad dressing, ranch dressing, commercial, regular
salad dressing, thousand island, commercial, regular	salad dressing, thousand island, commercial, regular
salad dressing, caesar dressing, regular	salad dressing, caesar dressing, regular
salad dressing, italian dressing, commercial, regular	salad dressing, italian dressing, commercial, regular
sauce, barbecue	sauce, barbecue
sauce, hot, chili, mature red, canned	sauce, hot, chili, mature red, canned
sauce, soy sauce made from soy and wheat (shoyu), low sodium	sauce, soy sauce made from soy and wheat (shoyu), low sodium
sauce, worcestershire	sauce, worcestershire
sauce, teriyaki, ready-to-serve, reduced sodium	sauce, teriyaki, ready-to-serve, reduced sodium
pesto, red or green	pesto, red or green
hummus, commercial	hummus, commercial
guacamole	guacamole
salsa	salsa
butter, salted	butter, salted
butter, without salt	butter, without salt
margarine, regular, 80% fat, composite, stick, with salt	margarine, regular, 80% fat, composite, stick, with salt
oil, olive, salad or cooking	oil, olive, salad or cooking
oil, canola	oil, canola
oil, vegetable, corn, industrial and retail, all purpose salad or cooking	oil, vegetable, corn, industrial and retail, all purpose salad or cooking
oil, sesame, salad or cooking	oil, sesame, salad or cooking
oil, coconut	oil, coconut
shortening, vegetable, household, composite	shortening, vegetable, household, composite
lard	lard
cream, heavy whipping	cream, heavy whipping
cream, light whipping	cream, light whipping
sour cream, regular	sour cream, regular
cream cheese	cream cheese
cottage cheese, creamed, large or small curd	cottage cheese, creamed, large or small curd
ricotta cheese, whole milk	ricotta cheese, whole milk
mozzarella cheese, whole milk	mozzarella cheese, whole milk
parmesan cheese, grated	parmesan cheese, grated
swiss cheese	swiss cheese
american cheese, pasteurized process	american cheese, pasteurized process
feta cheese	feta cheese
goat cheese, soft type	goat cheese, soft type
blue cheese	blue cheese
brie cheese	brie cheese
camembert cheese	camembert cheese
gouda cheese	gouda cheese
colby cheese	colby cheese
monterey cheese	monterey cheese
provolone cheese	provolone cheese
romano cheese	romano cheese
milk, whole, 3.25% milkfat, with added vitamin d	milk, whole, 3.25% milkfat, with added vitamin d
milk, lowfat, fluid, 1% milkfat, with added vitamin a and vitamin d	milk, lowfat, fluid, 1% milkfat, with added vitamin a and vitamin d
milk, nonfat, fluid, with added vitamin a and vitamin d (fat free or skim)	milk, nonfat, fluid, with added vitamin a and vitamin d (fat free or skim)
buttermilk, fluid, cultured, lowfat	buttermilk, fluid, cultured, lowfat
yogurt, greek, plain, nonfat	yogurt, greek, plain, nonfat
yogurt, greek, plain, lowfat	yogurt, greek, plain, lowfat
yogurt, vanilla, lowfat	yogurt, vanilla, lowfat
yogurt, fruit, lowfat	yogurt, fruit, lowfat
kefir, lowfat, plain, lifeway	kefir, lowfat, plain, lifeway
ice milk, vanilla	ice milk, vanilla
milkshake, thick vanilla	milkshake, thick vanilla
malted drink mix, chocolate, powder, prepared with milk	malted drink mix, chocolate, powder, prepared with milk
eggnog	eggnog
salad dressing, italian dressing, commercial, regular	salad dressing, italian dressing, commercial, regular