brussels sprouts, frozen, cooked, boiled, drained, without salt	brussels sprouts, frozen, cooked, boiled, drained, without salt
rice and wheat cereal bar	rice and wheat cereal bar
ravioli, cheese with tomato sauce, frozen, not prepared, includes regular and light entrees	ravioli, cheese with tomato sauce, frozen, not prepared, includes regular and light entrees
candies, mars snackfood us, m&m's peanut chocolate candies	candies, mars snackfood us, m&m's peanut chocolate candies
fast foods, taco with chicken, lettuce and cheese, soft	fast foods, taco with chicken, lettuce and cheese, soft
beverages, cocoa mix, powder	cocoa mix, powder
candies, mounds candy bar	candies, mounds candy bar
mushrooms, canned, drained solids	mushrooms, canned, drained solids
soup, onion, canned, condensed	soup, onion, canned, condensed
spices, nutmeg, ground	spices, nutmeg, ground
cheese, swiss, low fat	cheese, swiss, low fat
danish pastry, cheese	danish pastry, cheese
candies, gumdrops, starch jelly pieces	candies, gumdrops, starch jelly pieces
restaurant, latino, empanadas, beef, prepared	restaurant, latino, empanadas, beef, prepared
cake, angelfood, dry mix, prepared	cake, angelfood, dry mix, prepared
creamy dressing, made with sour cream and/or buttermilk and oil, reduced calorie, fat-free	creamy dressing, made with sour cream and/or buttermilk and oil, reduced calorie, fat-free
cereals, quaker, quaker multigrain oatmeal, dry	cereals, quaker, quaker multigrain oatmeal, dry
pie, cherry, commercially prepared	pie, cherry, commercially prepared
spices, cloves, ground	spices, cloves, ground
alcoholic beverage, liqueur, coffee with cream, 34 proof	alcoholic beverage, liqueur, coffee with cream, 34 proof
candies, reese's pieces candy	candies, reese's pieces candy
cookies, raisin, soft-type	cookies, raisin, soft-type
cookies, marshmallow, chocolate-coated (includes marshmallow pies)	cookies, marshmallow, chocolate-coated (includes marshmallow pies)
cereals ready-to-eat, kellogg, kellogg's, raisin bran crunch	cereals ready-to-eat, kellogg, kellogg's, raisin bran crunch
sweet potato, raw, unprepared (includes foods for usda's food distribution program)	rice, brown, long-grain, raw (includes foods for usda's food distribution program)
strawberry-flavor beverage mix, powder	strawberry-flavor beverage mix, powder
cauliflower, frozen, cooked, boiled, drained, without salt	cauliflower, frozen, cooked, boiled, drained, without salt
wild rice, cooked	wild rice, cooked
fish, snapper, mixed species, raw	fish, snapper, mixed species, raw
cookies, fortune	cookies, fortune
beef, brisket, whole, separable lean only, trimmed to 0" fat, all grades, cooked, braised	beef, brisket, whole, separable lean only, trimmed to 0" fat, all grades, cooked, braised
radicchio, raw	radicchio, raw
biscuits, plain or buttermilk, refrigerated dough, higher fat, baked	biscuits, plain or buttermilk, refrigerated dough, higher fat, baked
beef, chuck, arm pot roast, separable lean only, trimmed to 1/8" fat, select, raw	beef, chuck, arm pot roast, separable lean only, trimmed to 1/8" fat, select, raw
pie crust, standard-type, frozen, ready-to-bake, enriched, baked	pie crust, standard-type, frozen, ready-to-bake, enriched, baked
restaurant, chinese, general tso's chicken	restaurant, chinese, general tso's chicken
grape leaves, raw	grape leaves, raw
beans, white, mature seeds, cooked, boiled, without salt	beans, white, mature seeds, cooked, boiled, without salt
beef, round, eye of round, roast, separable lean only, trimmed to 1/8" fat, choice, raw	beef, round, eye of round, roast, separable lean only, trimmed to 1/8" fat, choice, raw
tomato juice, canned, with salt added	tomato juice, canned, with salt added
crackers, matzo, plain	crackers, matzo, plain
sour cream, fat free	sour cream, fat free
sauce, cocktail, ready-to-serve	sauce, cocktail, ready-to-serve
game meat, goat, cooked, roasted	game meat, goat, cooked, roasted
pork, fresh, variety meats and by-products, feet, cooked, simmered	pork, fresh, variety meats and by-products, feet, cooked, simmered
ravioli, cheese-filled, canned	ravioli, cheese-filled, canned
grapefruit juice, white, canned or bottled, unsweetened	grapefruit juice, white, canned, unsweetened
fast foods, hush puppies	fast foods, hush puppies
fast food, pizza chain, 14" pizza, pepperoni topping, thin crust	fast food, pizza chain, 14" pizza, pepperoni topping, thin crust
pork, fresh, shoulder, arm picnic, separable lean and fat, cooked, braised	pork, fresh, shoulder, arm picnic, separable lean and fat, cooked, braised
cookies, ladyfingers, with lemon juice and rind	cookies, ladyfingers, with lemon juice and rind
pie, egg custard, commercially prepared	pie, egg custard, commercially prepared
mollusks, mussel, blue, raw	mollusks, mussel, blue, raw
mollusks, clam, mixed species, raw	mollusks, clam, mixed species, raw
candies, caramels, chocolate-flavor roll	candies, caramels, chocolate-flavor roll
beef, composite of trimmed retail cuts, separable lean only, trimmed to 0" fat, all grades, cooked	beef, composite of trimmed retail cuts, separable lean only, trimmed to 0" fat, all grades, cooked
bread, cornbread, dry mix, prepared with 2% milk, 80% margarine, and eggs	bread, cornbread, prepared from recipe, made with low fat (2%) milk
candies, mars snackfood us, 3 musketeers bar	candies, mars snackfood us, 3 musketeers bar
candies, kit kat wafer bar	candies, kit kat wafer bar
snacks, granola bars, soft, coated, milk chocolate coating, peanut butter	snacks, granola bars, soft, coated, milk chocolate coating, peanut butter
cheese, swiss, low sodium	cheese, swiss, low sodium
beef, top sirloin, steak, separable lean only, trimmed to 1/8" fat, choice, raw	beef, top sirloin, steak, separable lean only, trimmed to 1/8" fat, choice, raw
snacks, pork skins, plain	snacks, pork skins, plain
leavening agents, cream of tartar	leavening agents, cream of tartar
luncheon meat, pork, ham, and chicken, minced, canned, reduced sodium, added ascorbic acid, includes spam, 25% less sodium	luncheon meat, pork, ham, and chicken, minced, canned, reduced sodium, added ascorbic acid, includes spam, 25% less sodium
fast foods, burrito, with beans, cheese, and beef	fast foods, burrito, with beans, cheese, and beef
fast foods, english muffin, with cheese and sausage	fast foods, english muffin, with egg, cheese, and sausage
peas, split, mature seeds, cooked, boiled, without salt	peas, split, mature seeds, cooked, boiled, without salt
snacks, granola bar, general mills nature valley, sweet&salty nut, peanut	snacks, granola bar, general mills nature valley, sweet&salty nut, peanut
mung beans, mature seeds, sprouted, cooked, boiled, drained, without salt	mung beans, mature seeds, sprouted, cooked, boiled, drained, without salt
pears, canned, water pack, solids and liquids	pears, canned, water pack, solids and liquids
frozen novelties, ice type, pop	frozen novelties, ice type, pop
rolls, hard (includes kaiser)	rolls, hard (includes kaiser)
fast foods, french toast sticks	fast foods, french toast sticks
soybeans, mature seeds, roasted, salted	soybeans, mature seeds, roasted, salted
spices, onion powder	spices, onion powder
oil, soybean, salad or cooking, (partially hydrogenated) and cottonseed	oil, soybean, salad or cooking, (partially hydrogenated) and cottonseed
beef, chuck for stew, separable lean and fat, all grades, cooked, braised	beef, chuck for stew, separable lean and fat, all grades, cooked, braised
soup, clam chowder, new england, canned, prepared with equal volume low fat (2%) milk	soup, clam chowder, new england, canned, prepared with equal volume low fat (2%) milk
pork, fresh, shoulder, arm picnic, separable lean only, cooked, braised	pork, fresh, shoulder, arm picnic, separable lean only, cooked, braised
pork, cured, shoulder, arm picnic, separable lean only, roasted	pork, cured, shoulder, arm picnic, separable lean only, roasted
fish, haddock, raw	fish, haddock, raw
pork, fresh, shoulder, (boston butt), blade (steaks), separable lean and fat, raw	pork, fresh, shoulder, (boston butt), blade (steaks), separable lean and fat, raw
pork, fresh, shoulder, (boston butt), blade (steaks), separable lean and fat,with added solution, raw	pork, fresh, shoulder, (boston butt), blade (steaks), separable lean and fat, raw
beverages, fruit flavored drink containing less than 3% fruit juice, with high vitamin c	fruit flavored drink containing less than 3% fruit juice, with high vitamin c
blackberries, frozen, unsweetened	blackberries, frozen, unsweetened
candies, mars snackfood us, twix caramel cookie bars	candies, mars snackfood us, twix caramel cookie bars
pork, fresh, shoulder, (boston butt), blade (steaks), separable lean only, cooked, braised	pork, fresh, shoulder, (boston butt), blade (steaks), separable lean only, cooked, braised
capers, canned	capers, canned
tomatoes, sun-dried	tomatoes, sun-dried
fast foods, griddle cake sandwich, egg, cheese, and sausage	fast foods, griddle cake sandwich, egg, cheese, and sausage
snacks, popcorn, caramel-coated, with peanuts	snacks, popcorn, caramel-coated, with peanuts
dressing, honey mustard, fat-free	dressing, honey mustard, fat-free
corn flour, masa, unenriched, white	corn flour, masa, unenriched, white
muffins, oat bran	muffins, oat bran
fast food, pizza chain, 14" pizza, sausage topping, thin crust	fast food, pizza chain, 14" pizza, sausage topping, thin crust
soup, cream of chicken, canned, condensed	soup, cream of chicken, canned, condensed
puddings, chocolate, dry mix, instant	puddings, chocolate, dry mix, instant
pork, fresh, shoulder, whole, separable lean only, cooked, roasted	pork, fresh, shoulder, whole, separable lean only, cooked, roasted
candies, white chocolate	candies, white chocolate
crackers, melba toast, plain	crackers, melba toast, plain
cereals ready-to-eat, malt-o-meal, frosted flakes	cereals ready-to-eat, malt-o-meal, frosted flakes
puddings, tapioca, ready-to-eat	puddings, tapioca, ready-to-eat
pizza, cheese topping, regular crust, frozen, cooked	pizza, cheese topping, regular crust, frozen, cooked
candies, nestle, baby ruth bar	candies, nestle, baby ruth bar
cookies, oatmeal, commercially prepared, special dietary	cookies, oatmeal, commercially prepared, special dietary
cake, pudding-type, chocolate, dry mix	cake, chocolate, dry mix, pudding-type
potato chips, without salt, reduced fat	potato chips, without salt, reduced fat
soup, black bean, canned, prepared with equal volume water	soup, black bean, canned, prepared with equal volume water
crustaceans, shrimp, mixed species, canned	crustaceans, shrimp, mixed species, canned
crackers, standard snack-type, regular	crackers, standard snack-type, regular
pork, fresh, composite of trimmed retail cuts (leg, loin, shoulder), separable lean only, raw	pork, fresh, composite of trimmed retail cuts (leg, loin, shoulder), separable lean only, raw
beef, cured, corned beef, canned	beef, cured, corned beef, canned
soup, pea, split with ham, canned, chunky, ready-to-serve	soup, pea, split with ham, canned, chunky, ready-to-serve
beef, corned beef hash, with potato, canned	beef, corned beef hash, with potato, canned
beets, canned, no salt added, solids and liquids	beets, canned, no salt added, solids and liquids
cranberries, raw	cranberries, raw
grapefruit juice, white, raw	grapefruit juice, white, raw
snacks, granola bites, mixed flavors	snacks, granola bites, mixed flavors
beef stew, canned entree	beef stew, canned entree
fast foods, english muffin, with egg, cheese, and sausage	fast foods, english muffin, with egg, cheese, and sausage
pancakes, buckwheat, dry mix, incomplete	pancakes, buckwheat, dry mix, incomplete
fast foods, biscuit, with egg, cheese, and bacon	fast foods, biscuit, with egg, cheese, and bacon
phyllo dough	phyllo dough
fast food, pizza chain, 14" pizza, sausage topping, thick crust	fast food, pizza chain, 14" pizza, sausage topping, thick crust
soybeans, mature cooked, boiled, without salt	soybeans, mature cooked, boiled, without salt
mollusks, octopus, common, raw	mollusks, octopus, common, raw
soup, egg drop, chinese restaurant	soup, egg drop, chinese restaurant
grapefruit juice, white, frozen concentrate, unsweetened, undiluted	grapefruit juice, white, frozen concentrate, unsweetened, undiluted
gelatin desserts, dry mix, prepared with water	gelatin desserts, dry mix, reduced calorie, with aspartame, prepared with water
fish, cod, atlantic, cooked, dry heat	fish, cod, atlantic, cooked, dry heat
cheese, pasteurized process, cheddar or american, low sodium	cheese, pasteurized process, cheddar or american, low sodium
cereals ready-to-eat, quaker, cap'n crunch's peanut butter crunch	cereals ready-to-eat, quaker, cap'n crunch's peanut butter crunch
soup, chicken with rice, canned, condensed	soup, chicken with rice, canned, condensed
soybean, curd cheese	soybean, curd cheese
tortellini, pasta with cheese filling, fresh-refrigerated, as purchased	tortellini, pasta with cheese filling, fresh-refrigerated, as purchased
cheese, mexican, queso anejo	cheese, mexican, queso anejo
pie, lemon meringue, commercially prepared	pie, lemon meringue, commercially prepared
carbonated beverage, cream soda	carbonated beverage, cream soda
margarine, regular, 80% fat, composite, stick, with salt, with added vitamin d	margarine, regular, 80% fat, composite, stick, with salt, with added vitamin d
garlic bread, frozen	garlic bread, frozen
popcorn, microwave, regular (butter) flavor, made with palm oil	popcorn, microwave, regular (butter) flavor, made with palm oil
beef, ground, 85% lean meat / 15% fat, raw (includes foods for usda's food distribution program)	rice, brown, long-grain, raw (includes foods for usda's food distribution program)
beef, ground, 80% lean meat / 20% fat, raw	beef, ground, 80% lean meat / 20% fat, raw
beef, ground, 75% lean meat / 25% fat, raw	beef, ground, 75% lean meat / 25% fat, raw
beef, ground, 90% lean meat / 10% fat, raw	beef, ground, 90% lean meat / 10% fat, raw
beef, ground, 95% lean meat / 5% fat, raw	beef, ground, 95% lean meat / 5% fat, raw
waterchestnuts, chinese, canned, solids and liquids	waterchestnuts, chinese, canned, solids and liquids
peas, edible-podded, frozen, cooked, boiled, drained, without salt	peas, edible-podded, frozen, cooked, boiled, drained, without salt
potatoes, hash brown, frozen, plain, prepared, pan fried in canola oil	potatoes, hashed brown, frozen, plain, prepared
alcoholic beverage, creme de menthe, 72 proof	alcoholic beverage, creme de menthe, 72 proof
ice creams, chocolate, light	ice creams, chocolate, light, no sugar added
ice creams, chocolate, light, no sugar added	ice creams, chocolate, light, no sugar added
pineapple, canned, water pack, solids and liquids	pineapple, canned, water pack, solids and liquids
peaches, canned, water pack, solids and liquids	peaches, canned, water pack, solids and liquids
oil, industrial, canola, high oleic	oil, industrial, canola, high oleic
oil, industrial, soy, fully hydrogenated	oil, industrial, soy, fully hydrogenated
oil, industrial, soy, low linolenic	oil, industrial, soy, low linolenic
oil, industrial, soy, ultra low linolenic	oil, industrial, soy, ultra low linolenic
cheese, cheddar (includes foods for usda's food distribution program)	cheese, cheddar (includes foods for usda's food distribution program)
yogurt, plain, skim milk	yogurt, plain, skim milk, 13 grams protein per 8 ounce
egg, white, raw, fresh	egg, white, raw, fresh
cream, sour, cultured	cream, sour, cultured
milk, buttermilk, dried	milk, buttermilk, dried
cheese product, pasteurized process, american, vitamin d fortified	cheese product, pasteurized process, american, reduced fat, fortified with vitamin d
butter, salted	butter, salted
yogurt, plain, low fat	yogurt, plain, low fat, 12 grams protein per 8 ounce
cheese, monterey	cheese, monterey
ice cream, bar or stick, chocolate covered	ice cream, bar or stick, chocolate covered
yogurt, plain, whole milk	yogurt, plain, whole milk, 8 grams protein per 8 ounce
cream, fluid, heavy whipping	cream, fluid, heavy whipping
cheese, parmesan, grated	cheese, parmesan, grated
milk, reduced fat, fluid, 2% milkfat, with added vitamin a and vitamin d	milk, reduced fat, fluid, 2% milkfat, with added vitamin a and vitamin d
cream, fluid, half and half	cream, fluid, half and half
sour cream, light	sour cream, light
milk, nonfat, fluid, with added vitamin a and vitamin d (fat free or skim)	milk, nonfat, fluid, with added vitamin a and vitamin d (fat free or skim)
cream substitute, powdered	cream substitute, powdered, light
spices, chili powder	spices, chili powder
cheese, cream	cheese, cream, fat free
cheese, blue	cheese, blue
cheese, fresh, queso fresco	cheese, fresh, queso fresco
cream, whipped, cream topping, pressurized	cream, whipped, cream topping, pressurized
milk, whole, 3.25% milkfat, with added vitamin d	milk, whole, 3.25% milkfat, with added vitamin d
cheese, colby	cheese, colby
cheese, feta	cheese, feta
egg, whole, dried	egg, whole, dried
milk, dry, nonfat, regular, without added vitamin a and vitamin d	milk, dry, nonfat, regular, without added vitamin a and vitamin d
eggnog	eggnog
cheese, cottage, lowfat, 2% milkfat	cheese, cottage, lowfat, 2% milkfat
cheese spread, pasteurized process, american	cheese spread, pasteurized process, american
cheese, gouda	cheese, gouda
cheese, swiss	cheese, swiss, low sodium
protein supplement, milk based, muscle milk light, powder	protein supplement, milk based, muscle milk light, powder
cheese, brick	cheese, brick
milk, chocolate, fluid, commercial, reduced fat, with added vitamin a and vitamin d	milk, chocolate, fluid, commercial, reduced fat, with added vitamin a and vitamin d
cheese, pasteurized process, american, without added vitamin d	cheese, pasteurized process, american, without added vitamin d
cheese, ricotta, part skim milk	cheese, ricotta, part skim milk
cheese, gruyere	cheese, gruyere
cheese, cottage, nonfat, uncreamed, dry, large or small curd	cheese, cottage, nonfat, uncreamed, dry, large or small curd
cream substitute, liquid, with hydrogenated vegetable oil and soy protein	cream substitute, liquid, with hydrogenated vegetable oil and soy protein