List_A_Item	Best_Match_from_List_B
butter, salted	unsalted butter
cheese, cheddar	none
cream, fluid, half and half	half and half
cream, sour, cultured	sour cream
milk, whole, 3.25% milkfat, with added vitamin d	whole milk
milk, reduced fat, fluid, 2% milkfat, with added vitamin a and vitamin d	whole milk
egg, whole, raw, fresh	none
egg, yolk, raw, fresh	brown egg yolk
chicken, broiler or fryers, breast, skinless, boneless, meat only, raw	none
soup, chicken broth, ready-to-serve	low sodium chicken broth
garlic, raw	garlic
mushrooms, white, raw	steamed whole white mushrooms
mushrooms, canned, drained solids	none
onions, raw	onion
peppers, sweet, green, raw	steamed whole green bell pepper w/o seed
tomatoes, red, ripe, raw, year round average	muir's diced tomatoes
tomatoes, red, ripe, canned, packed in tomato juice	muir's diced tomatoes
seaweed, wakame, raw	roasted seaweed
peppers, jalapeno, raw	jalapeno
beverages, coffee, brewed, prepared with tap water	brewed coffee
refried beans, canned, traditional style	refried beans
soy flour, defatted	soy flour
cocoa, dry powder, unsweetened	none
sugars, granulated	none
barley, pearled, raw	whole grain pearl barley
cornstarch	none
rice, white, long-grain, regular, raw, enriched	enriched long white rice (mahatma)
wheat flour, white, all-purpose, enriched, bleached	white bread
beef, top sirloin, steak, separable lean only, trimmed to 1/8 fat, choice, raw	none
celery, raw	steamed celery stalk
coriander (cilantro) leaves, raw	parsley
cucumber, with peel, raw	whole english cucumber
tomato products, canned, paste, without salt added	hunt's tomato paste
beverages, carbonated, cola, regular	coca cola
rice, white, long-grain, regular, enriched, cooked	enriched long white rice (mahatma)
wheat bran, crude	none
beef, ground, 90% lean meat / 10% fat, patty, cooked, broiled	ground pork
beef, ground, 85% lean meat / 15% fat, patty, cooked, broiled	ground pork
beef, ground, 80% lean meat / 20% fat, patty, cooked, broiled	ground pork
beef, ground, 75% lean meat / 25% fat, patty, cooked, broiled	ground pork
egg, white, raw, fresh	brown egg yolk
cheese product, pasteurized process, american, vitamin d fortified	american cheese
turkey, ground, cooked	ground turkey
cabbage, raw	none
tomato products, canned, sauce	hunt's tomato sauce
beef, top sirloin, steak, separable lean and fat, trimmed to 0 fat, all grades, cooked, broiled	none
beef, top sirloin, steak, separable lean only, trimmed to 0 fat, all grades, cooked, broiled	none
beef, round, top round steak, boneless, separable lean only, trimmed to 0 fat, all grades, cooked, grilled	none
beef, round, top round steak, boneless, separable lean and fat, trimmed to 0 fat, all grades, cooked, grilled	none
beverages, carbonated, sprite, lemon-lime, without caffeine	sprite
beverages, coffee, instant, decaffeinated, powder	none
beans, black, mature seeds, cooked, boiled, without salt	canned black beans (s&w)
beans, pinto, mature seeds, cooked, boiled, without salt	none
sugars, brown	none
candies, chocolate, dark, nfs (45-59% cacao solids 90%; 60-69% cacao solids 5%; 70-85% cacao solids 5%)	chocolate
beef, short loin, top loin, steak, separable lean only, trimmed to 1/8 fat, all grades, cooked, broiled	none
cheese spread, pasteurized process, american	none
lettuce, iceberg (includes crisphead types), raw	steamed iceberg lettuce
chicken, broiler, rotisserie, bbq, breast, meat only	none
orange juice, chilled, includes from concentrate	pulp free orange juice
mung beans, mature seeds, sprouted, raw	steamed whole snow peas
onions, young green, tops only	onion
nuts, almonds	pecan
nuts, walnuts, english	walnuts
beverages, carbonated, cola, without caffeine	none
beverages, coffee, brewed, prepared with tap water, decaffeinated	brewed coffee
beverages, tea, black, brewed, prepared with tap water	black tea
cornmeal, degermed, enriched, yellow	cornmeal
cheese, mozzarella, low moisture, part-skim	low moisture part skim mozarella cheese
cheese product, pasteurized process, american, reduced fat, fortified with vitamin d	none
cheese, pasteurized process, american, without added vitamin d	none
cheese spread, american or cheddar cheese base, reduced fat	sharp chedder cheese
cheese, cheddar, reduced fat	sharp chedder cheese
cranberries, dried, sweetened	cranberry
orange juice, chilled, includes from concentrate, with added calcium and vitamin d	pulp free orange juice
orange juice, chilled, includes from concentrate, with added calcium	pulp free orange juice
spinach, canned, regular pack, drained solids	canned black beans (s&w)
beans, kidney, red, mature seeds, raw	canned kidney beans
beans, kidney, red, mature seeds, canned, solids and liquids	canned kidney beans
snacks, popcorn, air-popped	popcorn
cheese, cream, low fat	sour cream
sausage, pork, chorizo, link or ground, cooked, pan-fried	ground pork
cheese, cottage, creamed, large or small curd	cottage cheese
chicken, broilers or fryers, thigh, meat only, cooked, roasted	none
cabbage, red, raw	purple cabbage
potatoes, boiled, cooked without skin, flesh, without salt	steamed whole russet potato
nuts, pecans	pecan
beverages, coffee, instant, regular, powder	brewed coffee
honey	honey
wheat flour, whole-grain (includes foods for usda's food distribution program)	whole wheat flour
pineapple, canned, water pack, solids and liquids	none
potatoes, baked, flesh, without salt	steamed russet potato flesh only
pickle relish, sweet	none
chicken, broiler, rotisserie, bbq, drumstick, meat only	none
parsley, fresh	parsley
sweet potato, cooked, baked in skin, flesh, without salt	steamed whole sweet potato
lima beans, immature seeds, frozen, fordhook, cooked, boiled, drained, without salt	lima beans
cauliflower, raw	steamed cauliflower florets and stalk
seeds, sunflower seed kernels, dry roasted, without salt	sunflower seeds
asparagus, raw	frozen whole baby asparagus
blueberries, raw	whole blueberry
peppers, sweet, green, cooked, boiled, drained, without salt	steamed green zuchini
nuts, cashew nuts, dry roasted, without salt added	cashew
beef, round, top round steak, separable lean and fat, trimmed to 1/8 fat, all grades, cooked, broiled	none
peanuts, all types, raw	peanuts
peanuts, all types, dry-roasted, with salt	peanuts
egg, whole, cooked, hard-boiled	brown egg yolk
beef, ground, 85% lean meat / 15% fat, crumbles, cooked, pan-browned	ground pork
beef, ground, 80% lean meat / 20% fat, crumbles, cooked, pan-browned	ground pork
butter, whipped, with salt	unsalted butter
yogurt, plain, whole milk	yogurt
apple juice, canned or bottled, unsweetened, without added ascorbic acid	apple juice
apricots, raw	whole apricot
blackberries, raw	none
grapes, red or green (european type, such as thompson seedless), raw	red seedless grape
peaches, yellow, raw	whole yellow peach (prima farms)
raspberries, raw	none
strawberries, raw	whole strawberry
blueberries, frozen, unsweetened	frozen whole blueberry
pears, raw	whole bartlett pear flesh only
chickpeas (garbanzo beans, bengal gram), mature seeds, cooked, boiled, without salt	none
turkey, all classes, light meat, cooked, roasted	none
onions, cooked, boiled, drained, without salt	onion
squash, summer, all varieties, cooked, boiled, drained, without salt	none
cheese, cottage, lowfat, 2% milkfat	cottage cheese
pineapple, raw, all varieties	gold (golden) pineapple
seaweed, laver, raw	roasted seaweed
beverages, coffee, brewed, espresso, restaurant-prepared	brewed coffee
soy sauce made from soy and wheat (shoyu), low sodium	soy sauce
syrups, maple	none
oat bran, raw	cooked oat bran
rice, white, glutinous, unenriched, cooked	enriched long white rice (mahatma)
cherries, sweet, raw	whole sweet cherry
grapefruit, raw, pink and red, all areas	deep red grapefruit
lime juice, raw	lime juice
melons, cantaloupe, raw	cantaloupe melon
beans, great northern, mature seeds, canned	canned black beans (s&w)
butter, without salt	unsalted butter
broccoli, frozen, chopped, cooked, boiled, drained, without salt	frozen broccoli florets
carrots, frozen, cooked, boiled, drained, without salt	steamed whole carrots
squash, summer, crookneck and straightneck, raw	steamed yellow neck squash
squash, summer, zucchini, includes skin, raw	none
cheese, cream	sour cream
bacon, turkey, microwaved	plant based bacon strip
cranberry sauce, canned, sweetened	cranberry
apple juice, canned or bottled, unsweetened, with added ascorbic acid	apple juice
beans, snap, green, frozen, cooked, boiled, drained without salt	none
sugars, powdered	none
plums, raw	whole red plum
peanuts, all types, dry-roasted, without salt	peanuts
turkey from whole, light meat, meat only, with added solution, cooked, roasted	none
tangerines, (mandarin oranges), canned, juice pack	pulp free orange juice
spinach, raw	none
beef, round, tip round, roast, separable lean only, trimmed to 0 fat, all grades, cooked, roasted	none
barley, pearled, cooked	whole grain pearl barley
butter oil, anhydrous	unsalted butter
salad dressing, mayonnaise, light	mayonnaise
snacks, popcorn, cheese-flavor	popcorn
peppers, sweet, red, raw	steamed whole red bell pepper w/o seed
mustard greens, raw	none
beverages, almond milk, unsweetened, shelf stable	none
beverages, coconut milk, sweetened, fortified with calcium, vitamins a, b12, d2	coconut milk
crustaceans, shrimp, mixed species, cooked, moist heat (may have been previously frozen)	shrimp
soy sauce made from soy and wheat (shoyu)	soy sauce
tofu, soft, prepared with calcium sulfate and magnesium chloride (nigari)	soft silken tofu
beans, snap, green, raw	none
mushrooms, white, cooked, boiled, drained, without salt	steamed whole white mushrooms
sweet potato, cooked, boiled, without skin	steamed whole sweet potato
orange juice, raw	pulp free orange juice
corn, sweet, yellow, frozen, kernels cut off cob, boiled, drained, without salt	frozen whole sweet green peas (flav r pac)
cowpeas, common (blackeyes, crowder, southern), mature seeds, cooked, boiled, without salt	black-eyed peas
turkey, whole, meat only, cooked, roasted	none
turkey, whole, meat only, with added solution, roasted	none
carrots, cooked, boiled, drained, without salt	steamed whole carrots
beverages, pepsico quaker, gatorade, g performance o 2, ready-to-drink.	gatorade
cabbage, cooked, boiled, drained, without salt	none
cauliflower, frozen, cooked, boiled, drained, without salt	none
squash, summer, crookneck and straightneck, frozen, cooked, boiled, drained, without salt	none
squash, summer, zucchini, includes skin, frozen, cooked, boiled, drained, without salt	none
seeds, pumpkin and squash seed kernels, roasted, without salt	none
nuts, almonds, dry roasted, without salt added	pecan
nuts, brazilnuts, dried, unblanched	brazil nuts
nuts, coconut milk, raw (liquid expressed from grated meat and water)	coconut milk
nuts, pistachio nuts, dry roasted, without salt added	none
lentils, mature seeds, cooked, boiled, without salt	whole grain brown lentils
collards, raw	steamed collard greens leaves and stalk
peas, split, mature seeds, cooked, boiled, without salt	green split peas
beef, top sirloin, steak, separable lean only, trimmed to 1/8 fat, all grades, cooked, broiled	none
yogurt, plain, low fat	yogurt
tomato products, canned, puree, with salt added	hunt's tomato paste
beans, kidney, red, mature seeds, cooked, boiled, without salt	canned kidney beans
beef, loin, top loin steak, boneless, lip off, separable lean only, trimmed to 0 fat, all grades, raw	none
beef, loin, top loin steak, boneless, lip off, separable lean and fat, trimmed to 0 fat, all grades, raw	none
melons, honeydew, raw	honeydew melon
lettuce, red leaf, raw	steamed whole red bell pepper w/o seed
okra, frozen, cooked, boiled, drained, without salt	frozen whole okra
beef, round, full cut, separable lean and fat, trimmed to 1/8 fat, choice, cooked, broiled	none
beef, ground, 75% lean meat / 25% fat, crumbles, cooked, pan-browned	ground pork
strawberries, frozen, unsweetened	frozen whole sweet green peas (flav r pac)
tangerines, (mandarin oranges), raw	pixie tangerine
snacks, banana chips	banana chips
turkey, dark meat, meat only, with added solution, cooked, roasted	none
spinach, frozen, chopped or leaf, cooked, boiled, drained, without salt	frozen chopped spinach (green giant)
crustaceans, shrimp, mixed species, raw (may contain additives to retain moisture)	shrimp
beef, round, top round steak, boneless, separable lean only, trimmed to 0 fat, all grades, raw	none
beans, black turtle, mature seeds, cooked, boiled, without salt	canned black beans (s&w)
cauliflower, cooked, boiled, drained, without salt	none
peppers, sweet, red, cooked, boiled, drained, without salt	steamed whole red bell pepper w/o seed
nuts, almonds, blanched	pecan
chickpeas (garbanzo beans, bengal gram), mature seeds, raw	canned garbanzo beans
applesauce, canned, sweetened, without salt	none
beef, round, top round roast, boneless, separable lean only, trimmed to 0 fat, all grades, raw	none
beef, round, top round roast, boneless, separable lean and fat, trimmed to 0 fat, all grades, raw	none
beef, round, eye of round roast, boneless, separable lean only, trimmed to 0 fat, all grades, raw	none
chicken, broilers or fryers, drumstick, meat only, cooked, braised	none
chicken, broilers or fryers, dark meat, thigh, meat only, cooked, braised	none
turkey, all classes, wing, meat and skin, cooked, roasted	none
turkey, wing, from whole bird, meat only, with added solution, roasted	none
beef, cured, breakfast strips, cooked	none
nuts, macadamia nuts, dry roasted, with salt added	pecan
grapefruit, sections, canned, water pack, solids and liquids	deep red grapefruit
brussels sprouts, raw	steamed whole brussel sprouts
cocoa, dry powder, unsweetened, processed with alkali	cocoa powder
beverages, coffee, brewed, espresso, restaurant-prepared, decaffeinated	brewed coffee
crustaceans, shrimp, mixed species, canned	shrimp
alfalfa seeds, sprouted, raw	alfalfa
turkey, whole, meat only, raw	none
chives, raw	chives
beef, ground, 95% lean meat / 5% fat, raw	ground pork
beef, ground, 90% lean meat / 10% fat, raw	ground pork
beef, ground, 80% lean meat / 20% fat, raw	ground pork
beef, ground, 75% lean meat / 25% fat, raw	ground pork
beets, raw	peeled, steamed beetroot
carrot juice, canned	carrot juice
frankfurter, turkey	none
nectarines, raw	whole yellow nectarine
watermelon, raw	none
okra, cooked, boiled, drained, without salt	frozen whole okra
plums, dried (prunes), stewed, without added sugar	none
turkey, thigh, from whole bird, meat only, with added solution, roasted	none
turkey, thigh, from whole bird, meat only, roasted	none
milk, chocolate, fat free, with added vitamin a and vitamin d	whole milk
kiwifruit, green, raw	kiwi
lettuce, cos or romaine, raw	romaine lettuce
seeds, pumpkin and squash seed kernels, dried	none
lima beans, large, mature seeds, cooked, boiled, without salt	lima beans
beans, snap, yellow, frozen, cooked, boiled, drained, without salt	frozen whole sweet green peas (flav r pac)
collards, cooked, boiled, drained, without salt	steamed collard greens leaves and stalk
kale, cooked, boiled, drained, without salt	kale
pumpkin, cooked, boiled, drained, without salt	none
seeds, flaxseed	golden flaxseed
beef, round, eye of round, roast, separable lean only, trimmed to 1/8 fat, choice, raw	none
beans, snap, green, cooked, boiled, drained, without salt	steamed green beans
cherries, sour, red, canned, water pack, solids and liquids	whole sweet cherry
artichokes, (globe or french), cooked, boiled, drained, without salt	canned artichoke hearts
spinach, cooked, boiled, drained, without salt	none
squash, winter, all varieties, cooked, baked, without salt	steamed butternut squash
wild rice, raw	none
kale, raw	kale
mushrooms, shiitake, cooked, without salt	steamed whole shiitake mushrooms
seaweed, kelp, raw	roasted seaweed
corn, sweet, white, frozen, kernels cut off cob, boiled, drained, without salt	frozen whole sweet green peas (flav r pac)
turkey, whole, neck, meat only, cooked, simmered	none
cowpeas (blackeyes), immature seeds, frozen, cooked, boiled, drained, without salt	black-eyed peas
sausage, meatless	beyond sausage
apricots, dried, sulfured, uncooked	dried apricots
mango, dried, sweetened	dried philippines mango (mariani)
bulgur, dry	none
beverages, wine, non-alcoholic	cabernet sauvignon wine
chard, swiss, cooked, boiled, drained, without salt	none
seaweed, agar, dried	roasted seaweed
beef, round, top round, separable lean and fat, trimmed to 1/8 fat, all grades, cooked, braised	none
cherries, sweet, canned, pitted, heavy syrup pack, solids and liquids	whole sweet cherry
pumpkin, canned, without salt	canned pumpkin
sour cream, light	sour cream
beans, pinto, mature seeds, raw	canned kidney beans
papayas, raw	tai nung papaya
basil, fresh	basil
nuts, pine nuts, dried	pine nut
asparagus, canned, drained solids	frozen whole baby asparagus
beverages, abbott, eas soy protein powder	protein powder
dates, deglet noor	dates
okra, raw	frozen whole okra
chicken, broilers or fryers, breast, skinless, boneless, meat only, with added solution, raw	none
cowpeas (blackeyes), immature seeds, cooked, boiled, drained, without salt	black-eyed peas
beef, top sirloin, steak, separable lean only, trimmed to 1/8 fat, choice, cooked, broiled	none
beef, round, full cut, separable lean and fat, trimmed to 1/8 fat, choice, raw	none
cheese, pasteurized process, american, fortified with vitamin d	none
peanuts, all types, oil-roasted, with salt	peanuts
chicken, broilers or fryers, meat only, stewed	none
beef, ground, 75% lean meat / 25% fat, loaf, cooked, baked	ground pork
marmalade, orange	pulp free orange juice
broccoli, frozen, chopped, unprepared	frozen broccoli florets
cauliflower, frozen, unprepared	none
corn, sweet, yellow, frozen, kernels cut off cob, unprepared	frozen whole sweet green peas (flav r pac)
peppers, sweet, red, frozen, chopped, unprepared	steamed whole red bell pepper w/o seed
wild rice, cooked	none
mangos, raw	tai nung papaya
beverages, abbott, eas whey protein powder	protein powder
yambean (jicama), raw	jicama
couscous, cooked	toasted pearl couscous
turkey, all classes, leg, meat and skin, cooked, roasted	none
mung beans, mature seeds, sprouted, cooked, boiled, drained, without salt	green split peas
eggplant, cooked, boiled, drained, without salt	eggplant
sweet potato, canned, vacuum pack	none
turkey, whole, light meat, meat and skin, cooked, roasted	none
turkey from whole, light meat, meat and skin, with added solution, cooked, roasted	none
soup, chicken broth, canned, condensed	low sodium chicken broth
brussels sprouts, frozen, cooked, boiled, drained, without salt	none
rice, white, long-grain, regular, cooked, enriched, with salt	enriched long white rice (mahatma)
rice noodles, cooked	stir fry rice noodle
peanuts, all types, oil-roasted, without salt	peanuts
chicken, broilers or fryers, light meat, meat only, cooked, stewed	none
eggplant, raw	eggplant
soy flour, full-fat, raw	soy flour
pork, cured, salt pork, raw	none
limes, raw	none
celery, cooked, boiled, drained, without salt	steamed celery stalk
butter, light, stick, with salt	unsalted butter
squash, summer, crookneck and straightneck, canned, drained, solid, without salt	steamed yellow neck squash
cheese spread, cream cheese base	cream cheese
sweet potato, raw, unprepared (includes foods for usda's food distribution program)	none
beverages, protein powder soy based	protein powder
pork, fresh, ground, cooked	none
bacon, meatless	plant based bacon strip
blueberries, frozen, sweetened	frozen whole blueberry
beverages, coffee, instant, regular, half the caffeine	brewed coffee
beef, flank, steak, separable lean only, trimmed to 0 fat, choice, raw	none
cheese, mozzarella, whole milk	whole milk
chicken, broilers or fryers, breast, meat only, cooked, roasted	none
wheat flour, white, all-purpose, unenriched	white bread
beef, round, tip round, roast, separable lean and fat, trimmed to 1/8 fat, choice, cooked, roasted	none
rice, white, long-grain, regular, unenriched, cooked without salt	enriched long white rice (mahatma)
lime juice, canned or bottled, unsweetened	lime juice
lima beans, immature seeds, cooked, boiled, drained, without salt	lima beans
beef, round, tip round, roast, separable lean and fat, trimmed to 1/8 fat, select, cooked, roasted	none
blueberries, canned, heavy syrup, solids and liquids	canned black beans (s&w)
pomegranates, raw	pomegranate w/ seeds
turkey, drumstick, from whole bird, meat only, with added solution, roasted	none
turkey, drumstick, from whole bird, meat only, roasted	none
cocoa, dry powder, hi-fat or breakfast, processed with alkali	cocoa powder
sour cream, reduced fat	sour cream
bulgur, cooked	none
soy protein isolate	none
cherries, sweet, canned, water pack, solids and liquids	whole sweet cherry
turkey, light or dark meat, smoked, cooked, skin and bone removed	none
turkey, light or dark meat, smoked, cooked, with skin, bone removed	none
asparagus, cooked, boiled, drained	frozen whole baby asparagus
artichokes, (globe or french), frozen, cooked, boiled, drained, without salt	canned artichoke hearts
asparagus, frozen, cooked, boiled, drained, without salt	frozen whole baby asparagus
squash, winter, spaghetti, cooked, boiled, drained, or baked, without salt	spaghetti
beef, round, tip round, roast, separable lean and fat, trimmed to 1/8 fat, all grades, cooked, roasted	none
seaweed, spirulina, dried	roasted seaweed
cheese, pasteurized process, cheddar or american, low sodium	none
grapefruit, sections, canned, light syrup pack, solids and liquids	deep red grapefruit
milk, reduced fat, fluid, 2% milkfat, without added vitamin a and vitamin d	whole milk
egg, whole, cooked, fried	none
turkey, whole, dark meat, cooked, roasted	none
arugula, raw	arugula
beans, kidney, all types, mature seeds, cooked, boiled, without salt	canned kidney beans
milk, whole, 3.25% milkfat, without added vitamin a and vitamin d	whole milk
apricots, dried, sulfured, stewed, without added sugar	dried apricots
chicken, cornish game hens, meat only, cooked, roasted	none
chard, swiss, raw	steamed whole red bell pepper w/o seed
turkey, whole, wing, meat only, cooked, roasted	none
cherries, sweet, canned, juice pack, solids and liquids	whole sweet cherry
turkey, wing, smoked, cooked, with skin, bone removed	none
snacks, popcorn, cakes	popcorn
turkey, whole, meat and skin, cooked, roasted	none
turkey, whole, meat and skin, with added solution, roasted	none
beans, black, mature seeds, raw	canned black beans (s&w)
turkey, whole, giblets, cooked, simmered	none
mustard greens, cooked, boiled, drained, without salt	none
cauliflower, green, cooked, no salt added	none
peanuts, all types, cooked, boiled, with salt	peanuts
tangerines, (mandarin oranges), canned, juice pack, drained	pulp free orange juice
cherries, sour, red, frozen, unsweetened	whole sweet cherry
brussels sprouts, cooked, boiled, drained, without salt	none
nuts, almond butter, plain, with salt added	almond butter (justin's)
grapefruit, raw, pink and red and white, all areas	deep red grapefruit
turkey, dark meat from whole, meat and skin, with added solution, cooked, roasted	none
kale, frozen, cooked, boiled, drained, without salt	kale
cheese, low-sodium, cheddar or colby	none
beverages, protein powder whey based	protein powder
pie fillings, blueberry, canned	none
cabbage, red, cooked, boiled, drained, without salt	none
buckwheat groats, roasted, cooked	hot cereal whole grain creamy buckwheat
blackberries, frozen, unsweetened	frozen whole sweet green peas (flav r pac)
cheese, mozzarella, nonfat	low moisture part skim mozarella cheese
nuts, almonds, oil roasted, without salt added	pecan
plantains, cooked	none
soymilk (all flavors), nonfat, with added calcium, vitamins a and d	soy milk
egg, whole, cooked, scrambled	none
protein supplement, milk based, muscle milk, powder	protein powder
tomatoes, red, ripe, canned, packed in tomato juice, no salt added	muir's diced tomatoes
turkey, back, from whole bird, meat and skin, with added solution, roasted	none
turkey, retail parts, thigh, meat and skin, cooked, roasted	none
protein supplement, milk based, muscle milk light, powder	protein powder
refried beans, canned, fat-free	refried beans
turkey, whole, dark meat, meat and skin, cooked, roasted	none
turkey, drumstick, smoked, cooked, with skin, bone removed	none
cheese, mozzarella, part skim milk	low moisture part skim mozarella cheese
turkey, whole, meat and skin, raw	none
turkey, retail parts, breast, meat and skin, with added solution, raw	none
beans, mature, red kidney, canned, solids and liquid, low sodium	canned kidney beans
nuts, cashew butter, plain, with salt added	cashew
cheese, american, nonfat or fat free	american cheese
cherries, tart, dried, sweetened (includes foods for usda's food distribution program)	whole sweet cherry
lentils, raw	whole grain brown lentils
quinoa, cooked	quinoa
cheese, pasteurized process, american, low fat	none
babyfood, fruit, applesauce, strained	original apple sauce (tree top)
beans, black turtle, mature seeds, canned	canned black beans (s&w)
mushrooms, shiitake, dried	steamed whole shiitake mushrooms
cheese, mozzarella, low sodium	low moisture part skim mozarella cheese
beverages, tea, black, ready-to-drink, lemon, sweetened	none
beverages, tea, black, ready to drink	black tea
yogurt, greek, plain, lowfat	yogurt
yogurt, greek, plain, whole milk	yogurt
beverages, tea, black, ready to drink, decaffeinated	none
apple juice, canned or bottled, unsweetened, with added ascorbic acid, calcium, and potassium	apple juice
beverages, tea, black, ready-to-drink, lemon, diet	none
beans, pinto, mature seeds, canned, solids and liquids, low sodium	canned black beans (s&w)
edamame, frozen, prepared	frozen edamame
beverages, tea, black, ready to drink, decaffeinated, diet	none
yogurt, greek, vanilla, lowfat	yogurt
beverages, cocoa mix, no sugar added, powder	none
babyfood, cereal, barley, dry fortified	whole grain pearl barley
refried beans, canned, traditional, reduced sodium	refried beans
cauliflower, green, raw	steamed cauliflower florets and stalk
blackberries, canned, heavy syrup, solids and liquids	canned black beans (s&w)
cherries, sweet, canned, light syrup pack, solids and liquids	whole sweet cherry
babyfood, cookies	chocolate chip cookies
egg, whole, cooked, poached	none
chicken breast, deli, rotisserie seasoned, sliced, prepackaged	chicken breast
chickpeas (garbanzo beans, bengal gram), mature seeds, canned, solids and liquids, low sodium	canned garbanzo beans
babyfood, cereal, rice, dry fortified	enriched long white rice (mahatma)
broccoli, frozen, spears, cooked, boiled, drained, without salt	frozen broccoli florets
reduced sodium: chicken breast, deli, rotisserie seasoned, sliced, prepackaged	chicken breast
pork sausage, link/patty, reduced fat, cooked, pan-fried	none
apples, raw, without skin	yellow banana flesh only
pork, cured, bacon, pre-sliced, cooked, pan-fried	none
peppers, hot chili, red, raw	steamed whole red bell pepper w/o seed
beef, chuck, blade roast, separable lean only, trimmed to 0 fat, all grades, cooked, braised	none
corn flour, masa, unenriched, white	cornmeal
frankfurter, beef, unheated	none
pork, fresh, loin, top loin (chops), boneless, separable lean and fat, raw	none
pork, fresh, shoulder, (boston butt), blade (steaks), separable lean and fat, raw	none
pork, fresh, loin, top loin (chops), boneless, separable lean and fat, with added solution, raw	none
pork, fresh, shoulder, (boston butt), blade (steaks), separable lean and fat,with added solution, raw	none
carrots, raw	steamed whole carrots
potatoes, baked, flesh and skin, without salt	steamed whole russet potato
catsup	tomato ketchup
beans, white, mature seeds, cooked, boiled, without salt	none
snacks, potato chips, plain, salted	none
rice flour, white, unenriched	enriched long white rice (mahatma)
pork, fresh, composite of trimmed retail cuts (leg, loin, shoulder), separable lean only, raw	none
tomato products, canned, puree, without salt added	hunt's tomato paste
beef, short loin, top loin, steak, separable lean and fat, trimmed to 1/8 fat, choice, cooked, grilled	none
beef, rib eye steak, boneless, lip-on, separable lean only, trimmed to 1/8 fat, all grades, cooked, grilled	none
beef, rib eye steak, boneless, lip-on, separable lean and fat, trimmed to 1/8 fat, all grades, cooked, grilled	none
pork, cured, ham, boneless, regular (approximately 11% fat), roasted	none
pork, cured, ham, boneless, extra lean and regular, roasted	none
pork, cured, ham -- water added, whole, boneless, separable lean and fat, heated, roasted	none
pork, cured, ham and water product, whole, boneless, separable lean and fat, heated, roasted	none
pork, cured, ham with natural juices, whole, boneless, separable lean and fat, heated, roasted	none
lettuce, green leaf, raw	steamed green zuchini
cereals, oats, regular and quick, not fortified, dry	whole grain oat cereal
oranges, raw, all commercial varieties	deep red grapefruit
alcoholic beverage, wine, table, all	cabernet sauvignon wine
pasta, cooked, enriched, without added salt	whole wheat spaghetti
ham, sliced, pre-packaged, deli meat (96%fat free, water added)	none
pork sausage, link/patty, cooked, pan-fried	none
sausage, turkey, breakfast links, mild, raw	ground pork
pork, cured, ham -- water added, whole, boneless, separable lean only, heated, roasted	none
pickles, cucumber, dill or kosher dill	pickles
beverages, tea, black, brewed, prepared with tap water, decaffeinated	black tea
soymilk, original and vanilla, with added calcium, vitamins a and d	soy milk
pineapple, canned, juice pack, drained	pulp free orange juice
corn, sweet, yellow, raw	frozen whole sweet green peas (flav r pac)
potatoes, boiled, cooked in skin, flesh, without salt	steamed whole russet potato
nuts, coconut meat, dried (desiccated), sweetened, flaked, packaged	dried coconut strips
beans, baked, canned, plain or vegetarian	canned black beans (s&w)
wheat flour, white, bread, enriched	white bread
apples, raw, with skin	whole golden del apple w/o seed
broccoli, raw	frozen broccoli florets
fish, tuna, light, canned in water, drained solids	albacore white tuna
chicken, broiler, rotisserie, bbq, thigh, meat only	none
pork, fresh, loin, top loin (chops), boneless, separable lean only, raw	none
pork, fresh, loin, top loin (chops), boneless, separable lean only, with added solution, raw	none
pork, fresh, variety meats and by-products, feet, cooked, simmered	none
beef, rib, large end (ribs 6-9), separable lean and fat, trimmed to 1/8 fat, all grades, cooked, roasted	none
corn, sweet, yellow, cooked, boiled, drained, without salt	none
onions, frozen, chopped, cooked, boiled, drained, without salt	onion
corn, sweet, white, cooked, boiled, drained, without salt	none
cheese, colby	none
sausage, italian, pork, cooked	ground pork
apples, dried, sulfured, uncooked	freeze dried apple rings
peanut butter, smooth style, with salt (includes foods for usda's food distribution program)	creamy peanut butter (skippy)
seeds, sesame butter, tahini, from roasted and toasted kernels (most common type)	tahini spread (365 whole foods market)
bananas, raw	yellow banana flesh only
corn, sweet, yellow, canned, whole kernel, drained solids	canned black beans (s&w)
pork, fresh, spareribs, separable lean and fat, cooked, braised	none
orange juice, frozen concentrate, unsweetened, undiluted	pulp free orange juice
beef, ground, patties, frozen, cooked, broiled	ground pork
carrots, canned, regular pack, drained solids	steamed whole carrots
cream, fluid, heavy whipping	none
beef, round, top round roast, boneless, separable lean only, trimmed to 0 fat, all grades, cooked, roasted	none
beef, round, top round roast, boneless, separable lean and fat, trimmed to 0 fat, all grades, cooked, roasted	none
onions, spring or scallions (includes tops and bulb), raw	onion
potatoes, flesh and skin, raw	steamed whole russet potato
pumpkin, raw	none
beef, chuck, arm pot roast, separable lean only, trimmed to 1/8 fat, choice, raw	none
cereals, corn grits, white, regular and quick, enriched, dry	none
beans, snap, green, canned, regular pack, drained solids	canned black beans (s&w)
alcoholic beverage, wine, table, red	cabernet sauvignon wine
rice, brown, long-grain, cooked	enriched long white rice (mahatma)
pork, fresh, loin, whole, separable lean only, cooked, roasted	none
alcoholic beverage, beer, regular, all	budweiser
pickles, cucumber, sour, low sodium	pickles
sausage, breakfast sausage, beef, pre-cooked, unprepared	ground pork
applesauce, canned, unsweetened, without added ascorbic acid (includes usda commodity)	none
pork, fresh, loin, center rib (chops), bone-in, separable lean only, cooked, braised	none
peas, green, frozen, cooked, boiled, drained, without salt	frozen whole sweet green peas (flav r pac)
fish, tuna, fresh, yellowfin, raw	albacore white tuna
beverages, tea, instant, decaffeinated, unsweetened	none
peaches, canned, water pack, solids and liquids	none
soup, stock, chicken, home-prepared	low sodium chicken broth
pasta, dry, enriched	whole wheat spaghetti
beverages, tea, instant, lemon, unsweetened	none
plantains, yellow, raw	plantain banana (steamed 10 in)
pork, fresh, shoulder, (boston butt), blade (steaks), separable lean only, cooked, braised	none
potatoes, hash brown, frozen, plain, prepared, pan fried in canola oil	none
beef, cured, corned beef, brisket, cooked	none
pie fillings, apple, canned	none
apple juice, frozen concentrate, unsweetened, undiluted, without added ascorbic acid	apple juice
pork, cured, ham, whole, separable lean only, roasted	none
pork, cured, ham, extra lean and regular, canned, roasted	none
pork, cured, ham, shank, bone-in, separable lean and fat, heated, roasted	none
pork, fresh, shoulder, arm picnic, separable lean and fat, cooked, braised	none
pears, canned, water pack, solids and liquids	whole bartlett pear flesh only
pickles, cucumber, sour	pickles
beans, snap, green, canned, no salt added, drained solids	canned black beans (s&w)
potato puffs, frozen, unprepared	frozen whole sweet green peas (flav r pac)
peas, green, raw	none
breakfast bar, corn flake crust with fruit	organic frosted flakes cereals
nuts, coconut meat, raw	dried coconut strips
pork, cured, ham and water product, whole, boneless, separable lean only, heated, roasted	none
pork, cured, ham with natural juices, whole, boneless, separable lean only, heated, roasted	none
cabbage, chinese (pak-choi), raw	steamed whole snow peas
plums, dried (prunes), uncooked	unsweetened pitted prunes
broccoli, cooked, boiled, drained, without salt	none
orange juice, frozen concentrate, unsweetened, undiluted, with added calcium	pulp free orange juice
turkey breast, sliced, prepackaged	none
beets, canned, no salt added, solids and liquids	canned black beans (s&w)
beef, chuck, arm pot roast, separable lean only, trimmed to 1/8 fat, all grades, cooked, braised	none
beef, chuck, arm pot roast, separable lean and fat, trimmed to 1/8 fat, all grades, cooked, braised	none
pork, fresh, composite of trimmed retail cuts (leg, loin, and shoulder), separable lean only, cooked	none
roast beef, deli style, prepackaged, sliced	none
cream, fluid, light (coffee cream or table cream)	sour cream
buckwheat flour, whole-groat	whole grain brown lentils
corn flour, masa, enriched, white	none
peppers, hot chili, green, raw	steamed whole green bell pepper w/o seed
beef, ground, 85% lean meat / 15% fat, raw (includes foods for usda's food distribution program)	ground pork
beef, rib, shortribs, separable lean only, choice, cooked, braised	none
pork, cured, ham, boneless, extra lean and regular, unheated	none
beets, pickled, canned, solids and liquids	canned black beans (s&w)
beverages, tea, instant, decaffeinated, lemon, diet	none
peas, green, cooked, boiled, drained, without salt	none
peas, green (includes baby and lesuer types), canned, drained solids, unprepared	green split peas
pork, fresh, shoulder, (boston butt), blade (steaks), separable lean only, raw	none
pork, fresh, shoulder, (boston butt), blade (steaks), separable lean only, with added solution, raw	none
mustard greens, frozen, cooked, boiled, drained, without salt	none
peas, green, canned, no salt added, solids and liquids	green split peas
beef, cured, corned beef, canned	none
beverages, tea, instant, lemon, diet	steamed whole snow peas
pasta, whole-wheat, cooked (includes foods for usda's food distribution program)	whole wheat spaghetti
peas, edible-podded, raw	steamed whole snow peas
nuts, almond paste	none
tomatoes, red, ripe, cooked	muir's diced tomatoes
soup, vegetable with beef broth, canned, prepared with equal volume water	chunky vegetable soup
pork, fresh, loin, whole, separable lean only, cooked, braised	none
broccoli, chinese, raw	frozen broccoli florets
beef, chuck, arm pot roast, separable lean and fat, trimmed to 1/8 fat, choice, cooked, braised	none
beef, chuck, arm pot roast, separable lean only, trimmed to 1/8 fat, choice, cooked, braised	none
pork, fresh, loin, tenderloin, separable lean and fat, raw	none
pork, fresh, loin, tenderloin, separable lean and fat, with added solution, raw	none
kielbasa, fully cooked, grilled	none
potatoes, baked, skin, without salt	steamed whole russet potato
beets, canned, drained solids	peeled, steamed beetroot
milk, imitation, non-soy	none
beef, round, bottom round , roast, separable lean only, trimmed to 1/8 fat, select, cooked, roasted	none
pork, cured, bacon, unprepared	none
beef, cured, pastrami	none
beef, brisket, whole, separable lean only, trimmed to 0 fat, all grades, cooked, braised	none
beef, brisket, whole, separable lean and fat, trimmed to 0 fat, all grades, cooked, braised	none
pork, fresh, shoulder, whole, separable lean only, cooked, roasted	none
corn, sweet, yellow, canned, no salt added, solids and liquids	canned black beans (s&w)
peas, edible-podded, boiled, drained, without salt	steamed whole snow peas
collards, frozen, chopped, cooked, boiled, drained, without salt	steamed collard greens leaves and stalk
apples, dried, sulfured, stewed, without added sugar	freeze dried apple rings
ice creams, chocolate, rich	vanilla bean ice cream
whey, sweet, dried	none
pork, cured, ham, center slice, country-style, separable lean only, raw	none
carrots, frozen, unprepared	none
peas, green, frozen, unprepared	frozen whole sweet green peas (flav r pac)
canadian bacon, cooked, pan-fried	ground pork
beef, cured, dried	none
beverages, tea, instant, unsweetened, powder	none
pork, fresh, loin, whole, separable lean only, raw	none
apples, raw, without skin, cooked, microwave	none
turkey, whole, breast, meat only, cooked, roasted	none
tomatoes, red, ripe, canned, stewed	muir's diced tomatoes
pork, fresh, shoulder, arm picnic, separable lean only, cooked, braised	none
pork, cured, shoulder, arm picnic, separable lean only, roasted	none
peppers, hot chili, red, canned, excluding seeds, solids and liquids	canned black beans (s&w)
cheese, brick	none
rice, brown, long-grain, raw	enriched long white rice (mahatma)
beef, rib, small end (ribs 10-12), separable lean only, trimmed to 1/8fat, choice, cooked, broiled	none
orange juice, canned, unsweetened	pulp free orange juice
beef, rib, shortribs, separable lean and fat, choice, cooked, braised	none
orange juice, frozen concentrate, unsweetened, diluted with 3 volume water	pulp free orange juice
beets, cooked, boiled, drained	none
carrots, canned, no salt added, solids and liquids	none
pork, fresh, variety meats and by-products, chitterlings, cooked, simmered	none
apricots, canned, light syrup pack, with skin, solids and liquids	none
pork, fresh, leg (ham), whole, separable lean and fat, cooked, roasted	none
soymilk, chocolate, with added calcium, vitamins a and d	soy milk
beef, chuck for stew, separable lean and fat, all grades, cooked, braised	none
peas, edible-podded, frozen, cooked, boiled, drained, without salt	steamed whole snow peas
beans, snap, yellow, cooked, boiled, drained, without salt	none
beef, rib, whole (ribs 6-12), separable lean and fat, trimmed to 1/8 fat, choice, cooked, roasted	none
pineapple, canned, juice pack, solids and liquids	none
pork, fresh, loin, whole, separable lean and fat, cooked, roasted	none
onions, frozen, whole, cooked, boiled, drained, without salt	frozen whole okra
pork, fresh, loin, tenderloin, separable lean only, raw	none
pork, fresh, enhanced, loin, tenderloin, separable lean only, raw	none
pork, cured, ham, extra lean and regular, canned, unheated	none
pork, cured, ham with natural juices, whole, boneless, separable lean and fat, unheated	none
pork, cured, ham and water product, whole, boneless, separable lean and fat, unheated	none
pork, cured, ham -- water added, whole, boneless, separable lean and fat, unheated	none
apricots, canned, heavy syrup pack, with skin, solids and liquids	none
ham, sliced, regular (approximately 11% fat)	ground pork
apricots, canned, juice pack, with skin, solids and liquids	none
pears, asian, raw	whole bartlett pear flesh only
vegetarian fillets	none
beef, composite of trimmed retail cuts, separable lean only, trimmed to 0 fat, all grades, cooked	none
pork, fresh, loin, tenderloin, separable lean only, cooked, roasted	none
cream, fluid, light whipping	sour cream
whey, acid, dried	sour cream
pork, cured, shoulder, arm picnic, separable lean and fat, roasted	none
pork, fresh, composite of trimmed retail cuts (leg, loin, shoulder, and spareribs), separable lean and fat, cooked	none
apples, dehydrated (low moisture), sulfured, uncooked	freeze dried apple rings
tofu, fried	soft silken tofu
pork, fresh, leg (ham), whole, separable lean only, cooked, roasted	none
beverages, coca-cola, powerade, lemon-lime flavored, ready-to-drink	coca cola
corn, sweet, white, canned, whole kernel, drained solids	canned black beans (s&w)
chicken, canned, no broth	canned black beans (s&w)
turkey, fryer-roasters, meat and skin, cooked, roasted	none
pork, cured, bacon, cooked, broiled, pan-fried or roasted, reduced sodium	none
beef, top sirloin, steak, separable lean only, trimmed to 1/8 fat, select, cooked, broiled	none
beef, top sirloin, steak, separable lean and fat, trimmed to 1/8 fat, choice, cooked, pan-fried	none
beef, chuck, arm pot roast, separable lean only, trimmed to 1/8 fat, select, raw	none
cabbage, chinese (pak-choi), cooked, boiled, drained, without salt	none
chicken patty, frozen, cooked	none
apricots, canned, water pack, with skin, solids and liquids	none
beef, composite of trimmed retail cuts, separable lean and fat, trimmed to 1/8 fat, all grades, cooked	none
pork, cured, ham, whole, separable lean only, unheated	none
pork, cured, ham and water product, whole, boneless, separable lean only, unheated	none
pork, cured, ham -- water added, whole, boneless, separable lean only, unheated	none
pork, cured, ham with natural juices, whole, boneless, separable lean only, unheated	none
pork, fresh, shoulder, whole, separable lean and fat, raw	none
pork, cured, ham, extra lean (approximately 4% fat), canned, unheated	none
nuts, coconut meat, dried (desiccated), sweetened, shredded	dried coconut strips
catsup, low sodium	none
beans, snap, yellow, canned, regular pack, drained solids	canned black beans (s&w)
pork, fresh, shoulder, whole, separable lean and fat, cooked, roasted	none
beef, chuck, blade roast, separable lean and fat, trimmed to 1/8 fat, all grades, cooked, braised	none
ham, chopped, not canned	ground pork
beans, baked, canned, no salt added	canned black beans (s&w)
beans, black, mature seeds, canned, low sodium	canned black beans (s&w)
babyfood, fortified cereal bar, fruit filling	none
fish, tuna, light, canned in oil, drained solids	albacore white tuna
pork, fresh, spareribs, separable lean and fat, raw	none
sausage, chicken or turkey, italian style,  lower sodium	none
bacon, turkey, low sodium	none
beverages, tea, ready-to-drink, lemon, diet	none
broccoli, chinese, cooked	none
beverages, tea, oolong, brewed	brewed coffee
beverages, chocolate powder, no sugar added	chocolate
reduced sodium: turkey breast, sliced, prepackaged	none
potatoes, canned, drained solids, no salt added	canned black beans (s&w)
cabbage, japanese style, fresh, pickled	none
cheese, monterey	none
cream substitute, powdered	half and half
milk, lowfat, fluid, 1% milkfat, with added vitamin a and vitamin d	whole milk
milk, nonfat, fluid, with added vitamin a and vitamin d (fat free or skim)	none
spices, cinnamon, ground	none
spices, paprika	none
spices, pepper, black	none
spices, turmeric, ground	none
salt, table, iodized	none
oil, soybean, salad or cooking	none
oil, olive, salad or cooking	none
oil, cottonseed, salad or cooking	none
oil, sunflower, linoleic, (approx. 65%)	sunflower seeds
oil, safflower, salad or cooking, high oleic (primary safflower oil of commerce)	none
oil, corn, industrial and retail, all purpose salad or cooking	none
oil, canola	none
margarine, regular, 80% fat, composite, stick, with salt	unsalted butter
margarine-like, vegetable oil spread, 60% fat, tub, with salt	unsalted butter
margarine, regular, 80% fat, composite, stick, with salt, with added vitamin d	unsalted butter
margarine-like, vegetable oil spread, 60% fat, tub, with salt, with added vitamin d	unsalted butter
potatoes, mashed, dehydrated, flakes without milk, dry form	none
alcoholic beverage, beer, light	budweiser
beverages, carbonated, ginger ale	none
water, tap, drinking	seedless watermelon
leavening agents, baking powder, double-acting, sodium aluminum sulfate	whole original english muffin (thomas)
syrups, corn, light	none
noodles, egg, enriched, cooked	stir fry rice noodle
chewing gum, sugarless	none
cream substitute, liquid, with hydrogenated vegetable oil and soy protein	half and half
spices, basil, dried	basil
spices, coriander leaf, dried	none
spices, ginger, ground	none
spices, marjoram, dried	none
spices, onion powder	onion
spices, sage, ground	beyond sausage
vinegar, distilled	none
lemon juice, raw	none
cassava, raw	none
potato flour	cornmeal
alcoholic beverage, distilled, all (gin, rum, vodka, whiskey) 80 proof	budweiser
cheese, mexican, queso asadero	none
lard	steamed collard greens leaves and stalk
oil, peanut, salad or cooking	peanuts
oil, sesame, salad or cooking	none
fat, turkey	ground pork
turkey, skin from whole, (light and dark), with added solution, roasted	none
raisins, seedless	none
beverages, tea, instant, lemon, sweetened, powder	steamed whole green bell pepper w/o seed
fat, chicken	low sodium chicken broth
grape juice, canned or bottled, unsweetened, with added ascorbic acid	pulp free orange juice
soybeans, mature seeds, sprouted, cooked, steamed	none
waterchestnuts, chinese, (matai), raw	steamed whole snow peas
sweeteners, tabletop, sucralose, splenda packets	none
sweeteners, tabletop, saccharin (sodium saccharin)	none
cheese, provolone	none
cheese, swiss	none
spices, chili powder	none
mustard, prepared, yellow	none
chicken, broilers or fryers, skin only, raw	none
beef, retail cuts, separable fat, cooked	none
beverages, lemonade fruit juice drink light, fortified with vitamin e and c	pulp free orange juice
vinegar, cider	none
oil, coconut	dried coconut strips
shortening, vegetable, household, composite	none
chicken, broilers or fryers, dark meat, drumstick, meat only, cooked, roasted	none
tamarinds, raw	none
juice, apple and grape blend, with added ascorbic acid	pulp free orange juice
leavening agents, yeast, baker's, active dry	whole wheat bread
vanilla extract, imitation, no alcohol	none
beverages, lemonade-flavor drink, powder	none
water, tap, municipal	none
fish, salmon, pink, raw	none
molasses	none
ginger root, raw	none
fish, haddock, raw	albacore white tuna
noodles, egg, dry, enriched	stir fry rice noodle
salad dressing, ranch dressing, regular	none
radishes, raw	none
fat, beef tallow	none
beverages, yellow green colored citrus soft drink with caffeine	sprite
beverages, carbonated, root beer	coca cola
cranberry juice, unsweetened	cranberry
cheese, parmesan, grated	none
beverages, carbonated, low calorie, cola or pepper-type, with aspartame, without caffeine	sprite
beverages, carbonated, low calorie, cola or pepper-type, with aspartame, contains caffeine	coca cola
milk, nonfat, fluid, without added vitamin a and vitamin d (fat free or skim)	none
grape juice, canned or bottled, unsweetened, without added ascorbic acid	pulp free orange juice
vitamin d as ingredient	none
cheese, blue	none
alcoholic beverage, wine, dessert, sweet	cabernet sauvignon wine
rye flour, medium	none
nopales, raw	none
beverages, chocolate-flavor beverage mix for milk, powder, with added nutrients	chocolate
milk, buttermilk, fluid, whole	whole milk
avocados, raw, all commercial varieties	none
crustaceans, crab, alaska king, imitation, made from surimi	none
leavening agents, baking soda	none
spices, nutmeg, ground	none
grapefruit juice, white, canned or bottled, unsweetened	deep red grapefruit
tangerine juice, raw	pulp free orange juice
fish, pollock, raw	albacore white tuna
fish, catfish, channel, farmed, raw	none
fish, tilapia, raw	albacore white tuna
cereals ready-to-eat, post, honey bunches of oats, honey roasted	honey nut oat cereal
cheese sauce, prepared from recipe	none
margarine,spread, 35-39% fat, tub	unsalted butter
margarine-like, vegetable oil spread, approximately 37% fat, unspecified oils, with salt, with added vitamin d	unsalted butter
chicken, broilers or fryers, giblets, cooked, simmered	none
apricot nectar, canned, with added ascorbic acid	pulp free orange juice
boysenberries, frozen, unsweetened	frozen whole sweet green peas (flav r pac)
lemons, raw, without peel	yellow banana flesh only
passion-fruit juice, purple, raw	tai nung papaya
pineapple juice, canned or bottled, unsweetened, without added ascorbic acid	pulp free orange juice
mango nectar, canned	none
babyfood, juice, pear	whole bartlett pear flesh only
beverages, slimfast, meal replacement,  high protein shake, ready-to-drink, 3-2-1 plan	none
fish, flatfish (flounder and sole species), raw	none
sweeteners, tabletop, aspartame, equal, packets	none
tomatoes, green, raw	muir's diced tomatoes
beef, variety meats and by-products, tripe, raw	none
tomatillos, raw	none
hominy, canned, white	canned black beans (s&w)
seeds, sesame seeds, whole, dried	none
lamb, composite of trimmed retail cuts, separable lean and fat, trimmed to 1/4 fat, choice, cooked	none
soup, beef broth or bouillon canned, ready-to-serve	chunky vegetable soup
whipped topping, frozen, low fat	none
yogurt, plain, skim milk	yogurt
chicken, broilers or fryers, thigh, meat and skin, raw	none
tomato juice, canned, with salt added	muir's diced tomatoes
peppers, serrano, raw	none
cheese, ricotta, part skim milk	none
alcoholic beverage, malt beer, hard lemonade	budweiser
mollusks, clam, mixed species, canned, drained solids	albacore white tuna
beef, variety meats and by-products, liver, cooked, pan-fried	none
chicken, broilers or fryers, wing, meat and skin, cooked, roasted	none
beverages, tea, herb, other than chamomile, brewed	none
nuts, hazelnuts or filberts	none
leavening agents, yeast, baker's, compressed	whole original english muffin (thomas)
chicken, broilers or fryers, drumstick, meat and skin, cooked, roasted	none
gravy, chicken, canned or bottled, ready-to-serve	canned black beans (s&w)
salad dressing, italian dressing, fat-free	none
gravy, beef, canned, ready-to-serve	canned black beans (s&w)
yogurt, frozen, flavors not chocolate, nonfat milk, with low-calorie sweetener	yogurt
spices, garlic powder	garlic
beverages, coconut water, ready-to-drink, unsweetened	dried coconut strips
fish, cod, pacific, raw (may have been previously frozen)	albacore white tuna
fish, sea bass, mixed species, raw	shrimp
figs, dried, uncooked	dried coconut strips
waterchestnuts, chinese, canned, solids and liquids	canned black beans (s&w)
fish, perch, mixed species, raw	albacore white tuna
olives, ripe, canned (small-extra large)	canned black beans (s&w)
beverages, carbonated, tonic water	none
chicken, liver, all classes, raw	none
animal fat, bacon grease	none
cheese, feta	none
yogurt, frozen, flavors other than chocolate, lowfat	yogurt
persimmons, japanese, raw	tai nung papaya
cheese, fresh, queso fresco	none
fish, salmon, chinook, smoked	none
cabbage, savoy, raw	none
soup, beef broth or bouillon, powder, dry	low sodium chicken broth
lemon peel, raw	none
cheese, ricotta, whole milk	none
beverages, orange breakfast drink, ready-to-drink, with added nutrients	pulp free orange juice
oil, industrial, coconut, confection fat, typical basis for ice cream coatings	dried coconut strips
beverages, carbonated, low calorie, other than cola or pepper,  without caffeine	sprite
beverages, energy drink, red bull	none
spices, pepper, red or cayenne	none
horseradish, prepared	none
frozen yogurts, chocolate, nonfat milk, sweetened without sugar	yogurt
prune juice, canned	unsweetened pitted prunes
beverages, aloe vera juice drink, fortified with vitamin c	none
snacks, pork skins, plain	none
margarine-like, vegetable oil spread, fat-free, tub	plant based bacon strip
spices, thyme, dried	none
crustaceans, crayfish, mixed species, wild, cooked, moist heat	shrimp
beverages, pepsico quaker, gatorade g2, low calorie	gatorade
beverages, cocoa mix, powder	none
alcoholic beverage, liqueur, coffee with cream, 34 proof	budweiser
fluid replacement, electrolyte solution (include pedialyte)	low sodium chicken broth
cheese, mexican blend	none
lamb, loin, separable lean only, trimmed to 1/4 fat, choice, cooked, broiled	none
lamb, loin, separable lean and fat, trimmed to 1/4 fat, choice, cooked, broiled	none
spices, cumin seed	none
spices, oregano, dried	none
oil, industrial, canola, high oleic	none
oil, industrial, soy, low linolenic	soy flour
oil, industrial, soy, ultra low linolenic	soy flour
oil, industrial, soy, fully hydrogenated	soy flour
cream, whipped, cream topping, pressurized	sour cream
snacks, beef jerky, chopped and formed	none
milk, buttermilk, fluid, cultured, reduced fat	sour cream
strawberry-flavor beverage mix, powder	none
beverages, unilever, slimfast, meal replacement, regular, ready-to-drink,  3-2-1 plan	none
fish, ocean perch, atlantic, raw	albacore white tuna
fish, whiting, mixed species, raw	shrimp
watercress, raw	none
orange pineapple juice blend	pulp free orange juice
veal, loin, separable lean and fat, raw	beef round tip steak
beverages, ovaltine, chocolate malt powder	none
margarine-like, vegetable oil spread, 20% fat, with salt	unsalted butter
milk, buttermilk, fluid, cultured, lowfat	sour cream
pimento, canned	none
beverages, orange-flavor drink, breakfast type, powder	pulp free orange juice
cheese, gruyere	none
bamboo shoots, raw	steamed whole snow peas
noodles, flat, crunchy, chinese restaurant	stir fry rice noodle
beverages, rice milk, unsweetened	none
turnips, raw	none
mollusks, clam, mixed species, raw	shrimp
fish, salmon, chum, canned, drained solids with bone	albacore white tuna
tapioca, pearl, dry	none
turnip greens, cooked, boiled, drained, without salt	none
margarine-like, vegetable oil spread, fat free, liquid, with salt	none
pigeonpeas, immature seeds, cooked, boiled, drained, without salt	steamed whole snow peas
crustaceans, crab, blue, cooked, moist heat	none
mollusks, squid, mixed species, raw	shrimp
cream, half and half, fat free	half and half
egg substitute, liquid or frozen, fat free	none
milk, buttermilk, dried	none
spices, parsley, dried	parsley
oil, pam cooking spray, original	none
pineapple juice, canned or bottled, unsweetened, with added ascorbic acid	pulp free orange juice
spices, cloves, ground	none
parmesan cheese topping, fat free	none
chicken, broilers or fryers, thigh, meat and skin, cooked, roasted	none
schiff,tiger's milk bar	none
guavas, common, raw	none
lamb, ground, raw	ground pork
braunschweiger (a liver sausage), pork	ground pork
turnip greens, canned, no salt added	steamed collard greens leaves and stalk
cheese, swiss, low fat	none
sauerkraut, canned, solids and liquids	none
margarine-like spread with yogurt, approximately 40% fat, tub, with salt	yogurt
veal, loin, separable lean only, cooked, roasted	beef round tip steak
fish, cod, atlantic, dried and salted	albacore white tuna
miso	none
alcoholic beverage, rice (sake)	none
pepper, banana, raw	yellow banana flesh only
veal, leg (top round), separable lean only, cooked, pan-fried, not breaded	none
cheese, brie	none
chicken, broilers or fryers, dark meat, drumstick, meat and skin, cooked, braised	none
fish, snapper, mixed species, raw	shrimp
papaya nectar, canned	tai nung papaya
carbonated beverage, cream soda	coca cola
fish, cod, atlantic, canned, solids and liquid	albacore white tuna
beverages, the coca-cola company, minute maid, lemonade	none
fish, croaker, atlantic, raw	albacore white tuna
fish, shark, mixed species, raw	shrimp
chicken, broilers or fryers, dark meat, thigh, meat and skin, cooked, braised	none
spices, poultry seasoning	none
guava sauce, cooked	none
lemon juice from concentrate, canned or bottled	pulp free orange juice
beverages, tea, green, brewed, decaffeinated	none
figs, raw	none
chicken, broilers or fryers, wing, meat and skin, cooked, stewed	none
turnip greens, frozen, cooked, boiled, drained, without salt	none
beverage, instant breakfast powder, chocolate, not reconstituted	protein powder
pork, fresh, backfat, raw	none
beans, pink, mature seeds, raw	canned kidney beans
fish, cod, atlantic, cooked, dry heat	albacore white tuna
mollusks, scallop, mixed species, raw	shrimp
cheese, goat, semisoft type	sharp chedder cheese
pear nectar, canned, without added ascorbic acid	whole bartlett pear flesh only
alcoholic beverage, creme de menthe, 72 proof	none
beverages, carbonated, club soda	none
cheese, cottage, nonfat, uncreamed, dry, large or small curd	cottage cheese
cheese, cream, fat free	sour cream
fish, trout, rainbow, farmed, raw	none
millet, puffed	none
crustaceans, lobster, northern, cooked, moist heat	none
reduced sodium: ham, sliced, pre-packaged, deli meat (96%fat free, water added)	none
beverages, carbonated, low calorie, other than cola or pepper, with aspartame, contains caffeine	sprite
oil, flaxseed, cold pressed	golden flaxseed
frozen yogurts, chocolate	yogurt
radicchio, raw	none
olives, pickled, canned or bottled, green	none
cranberries, raw	none
pears, dried, sulfured, uncooked	whole bartlett pear flesh only
spices, curry powder	none
lamb, shoulder, whole (arm and blade), separable lean and fat, trimmed to 1/4 fat, choice, cooked, roasted	none
lamb, shoulder, whole (arm and blade), separable lean only, trimmed to 1/4 fat, choice, cooked, roasted	none
fish, scup, raw	albacore white tuna
beverages, nestle, boost plus, nutritional drink, ready-to-drink	none
beverages, abbott, ensure, nutritional shake, ready-to-drink	none
chicken, broiler, rotisserie, bbq, wing, meat and skin	none
leeks, (bulb and lower leaf-portion), raw	none
beans, pink, mature seeds, cooked, boiled, without salt	canned black beans (s&w)
cheese, muenster, low fat	none
soybeans, mature cooked, boiled, without salt	none
snacks, plantain chips, salted	none
turnips, frozen, cooked, boiled, drained, without salt	none
beef, variety meats and by-products, tongue, cooked, simmered	none
soybeans, mature seeds, roasted, salted	peanuts
game meat, deer, loin, separable lean only, 1 steak, cooked, broiled	none
salad dressing, thousand island dressing, fat-free	none
game meat, deer, shoulder clod, separable lean only, cooked, braised	none
noodles, chinese, chow mein	stir fry rice noodle
cheese, muenster	none
mollusks, clam, mixed species, canned, liquid	albacore white tuna
oil, industrial, soy (partially hydrogenated), multiuse for non-dairy butter flavor	none
mollusks, mussel, blue, raw	none
chicken, gizzard, all classes, cooked, simmered	none
milk, dry, nonfat, regular, without added vitamin a and vitamin d	none
fish, cod, pacific, cooked, dry heat (may contain additives to retain moisture)	albacore white tuna
fish, salmon, pink, canned, total can contents	none
ham salad spread	none
malt beverage, includes non-alcoholic beer	budweiser
game meat, deer, ground, raw	ground pork
chicken, broilers or fryers, back, meat and skin, cooked, roasted	none
nopales, cooked, without salt	none
margarine, regular, 80% fat, composite, stick, without salt	unsalted butter
margarine, regular, 80% fat, composite, stick, without salt, with added vitamin d	unsalted butter
peaches, dried, sulfured, uncooked	unsweetened pitted prunes
margarine-like, margarine-butter blend, soybean oil and butter	unsalted butter
mung beans, mature seeds, cooked, boiled, without salt	green split peas
fish, swordfish, raw	none
leavening agents, baking powder, double-acting, straight phosphate	whole wheat flour
beverages, propel zero, fruit-flavored, non-carbonated	pulp free orange juice
beverages, tea, herb, brewed, chamomile	none
crustaceans, crab, blue, canned	none
chicken, feet, boiled	none
frozen yogurts, flavors other than chocolate	yogurt
veal, sirloin, separable lean and fat, cooked, roasted	none
shortening industrial, soybean (hydrogenated) and cottonseed	none
oil, industrial, soy (partially hydrogenated)  and cottonseed, principal use as a tortilla shortening	none
sweeteners, tabletop, fructose, dry, powder	none
rhubarb, raw	none
bamboo shoots, canned, drained solids	steamed whole snow peas
cheese, mexican, queso chihuahua	none
chayote, fruit, cooked, boiled, drained, without salt	none
guava nectar, with sucralose, canned	pulp free orange juice
milk, dry, nonfat, regular, with added vitamin a and vitamin d	none
baking chocolate, unsweetened, squares	chocolate
cheese, mexican, queso anejo	none
onions, dehydrated flakes	onion
chicken, liver, all classes, cooked, simmered	none
chicken, cornish game hens, meat and skin, cooked, roasted	none
game meat, goat, cooked, roasted	none
mollusks, oyster, eastern, wild, raw	none
chicken, broiler, rotisserie, bbq, thigh, meat and skin	none
milk, dry, whole, with added vitamin d	whole milk
spices, pumpkin pie spice	none
fish, salmon, sockeye, canned, drained solids	albacore white tuna
beverages, abbott, ensure plus, ready-to-drink	none
egg, whole, dried	none
grapefruit juice, white, frozen concentrate, unsweetened, undiluted	deep red grapefruit
margarine-like vegetable-oil spread, stick/tub/bottle, 60% fat, with added vitamin d	unsalted butter
sour cream, fat free	sour cream
cereals ready-to-eat, wheat germ, toasted, plain	honey nut oat cereal
oil, almond	almond butter (justin's)
fish, mackerel, atlantic, raw	albacore white tuna
fish, mackerel, pacific and jack, mixed species, raw	albacore white tuna
milk, goat, fluid, with added vitamin d	whole milk
spices, celery seed	steamed celery stalk
duck, domesticated, meat and skin, cooked, roasted	none
chicken, broilers or fryers, neck, meat and skin, cooked simmered	none
cheese, gouda	none
crustaceans, crayfish, mixed species, wild, raw	shrimp
lamb, foreshank, separable lean and fat, trimmed to 1/4 fat, choice, cooked, braised	none
milk, dry, nonfat, instant, with added vitamin a and vitamin d	none
crustaceans, lobster, northern, raw	none
lamb, leg, whole (shank and sirloin), separable lean and fat, trimmed to 1/4 fat, choice, cooked, roasted	none
lamb, leg, whole (shank and sirloin), separable lean only, trimmed to 1/4 fat, choice, cooked, roasted	none
cheese, romano	none
oil, industrial, soy ( partially hydrogenated), all purpose	none
leavening agents, cream of tartar	none
taro, cooked, without salt	none
yam, cooked, boiled, drained, or baked, without salt	steamed whole sweet potato
rutabagas, raw	none
celeriac, raw	steamed celery stalk
fish, pompano, florida, raw	none
candies, confectioner's coating, yogurt	yogurt
margarine-like, vegetable oil spread, 60% fat, stick/tub/bottle, with salt	unsalted butter
chicken, broilers or fryers, separable fat, raw	none
babyfood, teething biscuits	none
fish, sardine, atlantic, canned in oil, drained solids with bone	albacore white tuna
nuts, coconut cream, canned, sweetened	dried coconut strips
seeds, sesame seed kernels, dried (decorticated)	peanuts
cheese, cottage, lowfat, 1% milkfat	cottage cheese
alcoholic beverage, liqueur, coffee, 53 proof	budweiser
peach nectar, canned, with sucralose, without added ascorbic acid	none
turnips, cooked, boiled, drained, without salt	steamed whole carrots
chicken, broilers or fryers, dark meat, meat only, cooked, roasted	none
nuts, chestnuts, european, roasted	peanuts
sauce, horseradish	none
fish, herring, atlantic, raw	albacore white tuna
cheese, monterey, low fat	none
spices, caraway seed	none
game meat, bison, separable lean only, cooked, roasted	none
frog legs, raw	none
beverages, coffee substitute, cereal grain beverage, prepared with water	brewed coffee
fish, mackerel, jack, canned, drained solids	albacore white tuna
alcoholic beverage, wine, light	cabernet sauvignon wine
sweetener, herbal extract powder from stevia leaf	none
turtle, green, raw	green split peas
lamb, ground, cooked, broiled	ground pork
game meat, deer, ground, cooked, pan-broiled	none
grape leaves, raw	none
dandelion greens, cooked, boiled, drained, without salt	none
milk, dry, whole, without added vitamin d	whole milk
balsam-pear (bitter gourd), pods, cooked, boiled, drained, without salt	steamed whole snow peas
fish, mullet, striped, raw	albacore white tuna
capers, canned	none
margarine, regular, 80% fat, composite, tub, with salt	unsalted butter
margarine, regular, 80% fat, composite, tub, with salt, with added vitamin d	unsalted butter
veal, sirloin, separable lean and fat, raw	none
pork, fresh, variety meats and by-products, stomach, raw	none
candies, soft fruit and nut squares	peanuts
fish, herring, atlantic, pickled	none
pate, chicken liver, canned	none
chicken, broiler, rotisserie, bbq, breast, meat and skin	none
beef, variety meats and by-products, liver, cooked, braised	none
blackberry juice, canned	canned black beans (s&w)
rutabagas, cooked, boiled, drained, without salt	none
alcoholic beverage, distilled, rum, 80 proof	none
fish, carp, raw	none
taro, raw	none
oil, soybean, salad or cooking, (partially hydrogenated) and cottonseed	none
fish, roe, mixed species, raw	shrimp
gravy, turkey, canned, ready-to-serve	none
mollusks, oyster, eastern, canned	none
cheese, parmesan, hard	none
oil, soybean, salad or cooking, (partially hydrogenated)	none
babyfood, fruit, apple and raspberry, strained	original apple sauce (tree top)
beverages, coffee, instant, mocha, sweetened	brewed coffee
whipped cream substitute, dietetic, made from powdered mix	sour cream
lamb, cubed for stew or kabob (leg and shoulder), separable lean only, trimmed to 1/4 fat, cooked, braised	none
beverage, instant breakfast powder, chocolate, sugar-free, not reconstituted	protein powder
alcoholic beverage, wine, table, white	cabernet sauvignon wine
water, bottled, generic	none
escarole, cooked, boiled, drained, no salt added	none
waxgourd, (chinese preserving melon), cooked, boiled, drained, without salt	steamed whole snow peas
pork, fresh, separable fat, cooked	none
water, non-carbonated, bottles, natural fruit flavors, sweetened with low calorie sweetener	pulp free orange juice
beet greens, cooked, boiled, drained, without salt	none
currants, zante, dried	none
grapefruit juice, white, raw	deep red grapefruit
game meat, rabbit, domesticated, composite of cuts, cooked, stewed	ground pork
cream substitute, flavored, liquid	half and half
beverages, cytosport, muscle milk, ready-to-drink	none
duck, domesticated, meat only, cooked, roasted	none
broadbeans (fava beans), mature seeds, cooked, boiled, without salt	whole grain brown lentils
beef, variety meats and by-products, brain, cooked, simmered	none
chicken, broiler, rotisserie, bbq, drumstick, meat and skin	none
beverages, water with added vitamins and minerals, bottles, sweetened, assorted fruit flavors	pulp free orange juice
fish, halibut, atlantic and pacific, raw	albacore white tuna
parsnips, cooked, boiled, drained, without salt	steamed whole carrots
beverages, carbonated, reduced sugar, cola, contains caffeine and sweeteners	coca cola
veal, ground, cooked, broiled	ground pork
spices, mustard seed, ground	garlic
beverages, coffee substitute, cereal grain beverage, powder	none
taro leaves, raw	none
carbonated beverage, chocolate-flavored soda	coca cola
babyfood, apple-banana juice	pulp free orange juice
beef, variety meats and by-products, heart, cooked, simmered	none
quail, cooked, total edible	none
rhubarb, frozen, uncooked	frozen whole okra
game meat, boar, wild, cooked, roasted	none
veal, leg (top round), separable lean and fat, cooked, braised	none
fish, eel, mixed species, raw	shrimp
game meat, moose, cooked, roasted	none
radishes, oriental, cooked, boiled, drained, without salt	steamed whole red bell pepper w/o seed
fish, caviar, black and red, granular	none
burdock root, raw	none
game meat, raccoon, cooked, roasted	none
mollusks, snail, raw	none
cheese, camembert	none
yogurt, greek, plain, nonfat (includes foods for usda's food distribution program)	yogurt
milk dessert bar, frozen, made from lowfat milk	vanilla bean ice cream
mollusks, scallop, (bay and sea), cooked, steamed	none
soymilk, original and vanilla, light, with added calcium, vitamins a and d	soy milk
cheese, mexican, blend, reduced fat	none
beverages, energy drink, vault, citrus flavor	none
cream substitute, powdered, light	half and half
cream substitute, liquid, light	half and half
beverages, orange juice, light, no pulp	pulp free orange juice
guanabana nectar, canned	none
beverages, the coca-cola company, hi-c flashin' fruit punch	none
hearts of palm, raw	none
syrups, corn, high-fructose	none
cheese, swiss, low sodium	none
beverages, energy drink, rockstar	none
chicken, broilers or fryers, meat and skin and giblets and neck, roasted	none
cream substitute, flavored, powdered	half and half
cheese, provolone, reduced fat	none
beverages, energy drink, red bull, sugar free, with added caffeine, niacin, pantothenic acid, vitamins b6 and b12	none
beverages, energy drink, monster, fortified with vitamins c, b2, b3, b6, b12	none
beet greens, raw	none
dandelion greens, raw	none
natto	none
fennel, bulb, raw	steamed celery stalk
game meat, bear, cooked, simmered	none
chicken, broilers or fryers, skin only, cooked, roasted	none
pomegranate juice, bottled	pomegranate w/ seeds
macaroni, vegetable, enriched, cooked	enriched long white rice (mahatma)
beverages, energy drink, rockstar, sugar free	none
beverages, coffee, instant, with whitener, reduced calorie	brewed coffee
veal, composite of trimmed retail cuts, separable lean only, cooked	ground pork
fish, pike, northern, raw	none
lotus root, cooked, boiled, drained, without salt	none
pokeberry shoots, (poke), cooked, boiled, drained, without salt	steamed whole green bell pepper w/o seed
cress, garden, raw	none
lamb, rib, separable lean and fat, trimmed to 1/4 fat, choice, cooked, broiled	none
lamb, rib, separable lean only, trimmed to 1/4 fat, choice, cooked, broiled	none
beverages, energy drink, amp	none
babyfood, fruit, bananas with tapioca, strained	yellow banana flesh only
babyfood, fruit, bananas with tapioca, junior	yellow banana flesh only
soymilk, chocolate and other flavors, light, with added calcium, vitamins a and d	soy milk
fish, sturgeon, mixed species, raw	albacore white tuna
beverages, energy drink, amp, sugar free	none
snacks, sweet potato chips, unsalted	none
milk, fluid, nonfat, calcium fortified (fat free or skim)	none
babyfood, water, bottled, gerber, without added fluoride	none
millet, cooked	whole grain brown lentils
litchis, raw	none
babyfood, dessert, custard pudding, vanilla, strained	none
babyfood, dessert, custard pudding, vanilla, junior	none
beverages, powerade, zero, mixed berry	none
candies, carob, unsweetened	none
beverages, tea, hibiscus, brewed	none
kohlrabi, raw	none
pumpkin flowers, cooked, boiled, drained, without salt	none
fish, herring, atlantic, kippered	albacore white tuna
veal, leg (top round), separable lean and fat, cooked, roasted	none
lamb, shoulder, whole (arm and blade), separable lean and fat, trimmed to 1/4 fat, choice, raw	none
veal, composite of trimmed retail cuts, separable lean and fat, cooked	ground pork
kumquats, raw	none
potatoes, mashed, dehydrated, prepared from flakes without milk, whole milk and butter added	steamed whole russet potato
figs, dried, stewed	none
beverages, acai berry drink, fortified	coconut milk
snacks, peas, roasted, wasabi-flavored	steamed whole snow peas
chayote, fruit, raw	none
beverages, water, bottled, yumberry, pomegranate with anti-oxidants, zero calories	pomegranate w/ seeds
sweetener, syrup, agave	honey
pears, dried, sulfured, stewed, without added sugar	whole bartlett pear flesh only
veal, leg (top round), separable lean and fat, cooked, pan-fried, breaded	none
veal, leg (top round), separable lean and fat, cooked, pan-fried, not breaded	none
beverages, unilever, slimfast shake mix, powder, 3-2-1 plan	none
beverages, kellogg's, special k protein shake	none
beverages, energy drink, sugar free	none
peanut flour, defatted	peanuts
cheese, cheddar, nonfat or fat free	sharp chedder cheese
cheese, swiss, nonfat or fat free	none
beverages, monster energy drink, low carb	none
beverages, the coca-cola company, nos energy drink, original, grape, loaded cherry, charged citrus, fortified with vitamins b6 and b12	none
beef, variety meats and by-products, kidneys, cooked, simmered	none
game meat, beaver, cooked, roasted	none
beverages, unilever, slimfast shake mix, high protein, whey powder, 3-2-1 plan,	none
balsam-pear (bitter gourd), leafy tips, cooked, boiled, drained, without salt	none
broccoli raab, raw	frozen broccoli florets
loganberries, frozen	frozen whole sweet green peas (flav r pac)
sour cream, imitation, cultured	sour cream
blueberries, dried, sweetened	whole blueberry
broccoli raab, cooked	none
babyfood, dessert, peach yogurt	yogurt
beverages, energy drink, vault zero, sugar-free, citrus flavor	none
babyfood, dinner, pasta with vegetables	whole wheat spaghetti
pork, cured, feet, pickled	none
game meat, squirrel, cooked, roasted	none
duck, domesticated, meat only, raw	none
yogurt, greek, strawberry, lowfat	yogurt
yogurt, greek, fruit, whole milk	yogurt
beverages, tea, green, brewed, regular	none
grapefruit juice, pink or red, with added calcium	deep red grapefruit
beverages, amber, hard cider	none
grape juice, canned or bottled, unsweetened, with added ascorbic acid and calcium	pulp free orange juice
alcoholic beverages, beer, higher alcohol	budweiser
egg, quail, whole, fresh, raw	brown egg yolk
yogurt, greek, strawberry, nonfat	yogurt
beverages, tea, green, ready to drink, unsweetened	none
alcoholic beverage, beer, light, higher alcohol	budweiser
fish, salmon, sockeye, raw	none
wasabi	none
beans, yellow, mature seeds, cooked, boiled, without salt	canned black beans (s&w)
yogurt, greek, vanilla, nonfat	yogurt
beverages, coffee, ready to drink, milk based, sweetened	brewed coffee
beverages, the coca-cola company, glaceau vitamin water, revive fruit punch, fortified	none
beverages, tea, green, ready-to-drink, sweetened	none
kefir, lowfat, plain, lifeway	yogurt
kefir, lowfat, strawberry, lifeway	none
alcoholic beverage, beer, light, low carb	budweiser
beverages, tea, green, ready-to-drink, diet	none
beverages, malted drink mix, natural, powder, dairy based.	none
alcoholic beverages, wine, rose	cabernet sauvignon wine
succotash, (corn and limas), frozen, cooked, boiled, drained, without salt	frozen whole sweet green peas (flav r pac)
cheese, mexican, queso cotija	none
margarine-like, vegetable oil-butter spread, reduced calorie, tub, with salt	unsalted butter
mollusks, octopus, common, raw	shrimp
beverages, apple juice drink, light, fortified with vitamin c	pulp free orange juice
beverages, kellogg's special k20 protein powder	protein powder
mollusks, abalone, mixed species, raw	shrimp
beverages, powerade zero ion4, calorie-free, assorted flavors	none
peaches, dried, sulfured, stewed, without added sugar	none
beverages, energy drink, full throttle	none
potatoes, mashed, home-prepared, whole milk added	steamed whole russet potato
dove, cooked (includes squab)	none
beverages,  energy drink, citrus	pulp free orange juice
cereals ready-to-eat, barbara's puffins, original	honey nut oat cereal
babyfood, grape juice, no sugar, canned	none
child formula, abbott nutrition, pediasure, ready-to-feed	none
passion-fruit, (granadilla), purple, raw	tai nung papaya
noodles, egg, spinach, enriched, cooked	stir fry rice noodle
sweet potato leaves, cooked, steamed, without salt	steamed whole sweet potato
chicken, broilers or fryers, back, meat and skin, cooked, stewed	none
beverages, ocean spray, cran-energy, cranberry energy juice drink	cranberry
cheese, fontina	none
mollusks, octopus, common, cooked, moist heat	shrimp
carob flour	soy flour
radishes, hawaiian style, pickled	none
soup, beef broth, less/reduced sodium, ready to serve	chunky vegetable soup
