guava sauce cooked	guava sauce cooked
candies milk chocolate coated coffee beans	candies milk chocolate coated coffee beans
veggie burgers soyburgers unprepared	veggie burgers soyburgers unprepared
chocolate flavored hazelnut spread	chocolate flavored hazelnut spread
cookies brownies commercially prepared	cookies brownies commercially prepared
cake yellow commercially prepared without frosting	cake yellow commercially prepared without frosting
cake chocolate commercially prepared without frosting	cake chocolate commercially prepared without frosting
cake white commercially prepared without frosting	cake white commercially prepared without frosting
cake pound commercially prepared butter	cake pound commercially prepared butter
cake sponge commercially prepared	cake sponge commercially prepared
cake angelfood commercially prepared	cake angelfood commercially prepared
cake fruitcake commercially prepared	cake fruitcake commercially prepared
cake boston cream pie commercially prepared	cake boston cream pie commercially prepared
cake carrot commercially prepared	cake carrot commercially prepared
cake german chocolate commercially prepared	cake german chocolate commercially prepared
cake gingerbread commercially prepared	cake gingerbread commercially prepared
cake coffeecake commercially prepared	cake coffeecake commercially prepared
cake cheese commercially prepared	cake cheese commercially prepared
cake pineapple upside down commercially prepared	cake pineapple upside down commercially prepared
cake red velvet commercially prepared	cake red velvet commercially prepared
cake shortcake biscuit type prepared from recipe	cake shortcake biscuit type prepared from recipe
snack cakes commercially prepared	snack cakes commercially prepared
cookies chocolate chip commercially prepared regular higher fat	cookies chocolate chip commercially prepared regular higher fat
cookies chocolate chip commercially prepared regular lower fat	cookies chocolate chip commercially prepared regular lower fat
cookies chocolate chip commercially prepared soft type	cookies chocolate chip commercially prepared soft type
cookies oatmeal commercially prepared regular	cookies oatmeal commercially prepared regular
cookies oatmeal commercially prepared soft type	cookies oatmeal commercially prepared soft type
cookies peanut butter commercially prepared regular	cookies peanut butter commercially prepared regular
cookies peanut butter commercially prepared soft type	cookies peanut butter commercially prepared soft type
cookies sugar commercially prepared regular	cookies sugar commercially prepared regular
cookies vanilla wafers higher fat	cookies vanilla wafers higher fat
cookies vanilla wafers lower fat	cookies vanilla wafers lower fat
cookies graham crackers plain or honey includes cinnamon	cookies graham crackers plain or honey includes cinnamon
cookies graham crackers chocolate coated	cookies graham crackers chocolate coated
cookies animal crackers includes arrowroot tea biscuits	cookies animal crackers includes arrowroot tea biscuits
cookies fig bars	cookies fig bars
cookies molasses	cookies molasses
cookies gingerbread	cookies gingerbread
cookies sandwich dark and light	cookies sandwich dark and light
cookies sandwich chocolate with creme filling regular	cookies sandwich chocolate with creme filling regular
cookies sandwich chocolate with creme filling reduced fat	cookies sandwich chocolate with creme filling reduced fat
cookies sandwich vanilla with creme filling regular	cookies sandwich vanilla with creme filling regular
cookies sandwich vanilla with creme filling reduced fat	cookies sandwich vanilla with creme filling reduced fat
cookies ladyfingers with lemon juice and rind	cookies ladyfingers with lemon juice and rind
cookies shortbread commercially prepared plain	cookies shortbread commercially prepared plain
cookies shortbread commercially prepared pecan	cookies shortbread commercially prepared pecan
cookies butter commercially prepared	cookies butter commercially prepared
cookies fortune	cookies fortune
cookies coconut macaroons	cookies coconut macaroons
cookies raisin soft type	cookies raisin soft type
cookies fudge cake type chocolate coated	cookies fudge cake type chocolate coated
cookies marshmallow chocolate coated coconut or marshmallow	cookies marshmallow chocolate coated coconut or marshmallow
cookies chocolate wafers	cookies chocolate wafers
crackers cheese regular	crackers cheese regular
crackers cheese reduced fat	crackers cheese reduced fat
crackers cheese sandwich type with cheese filling	crackers cheese sandwich type with cheese filling
crackers cheese sandwich type with peanut butter filling	crackers cheese sandwich type with peanut butter filling
crackers saltines including oyster soda soup	crackers saltines including oyster soda soup
crackers saltines fat free low sodium	crackers saltines fat free low sodium
crackers saltines low salt includes oyster soda soup	crackers saltines low salt includes oyster soda soup
crackers saltines unsalted tops includes oyster soda soup	crackers saltines unsalted tops includes oyster soda soup
crackers whole wheat	crackers whole wheat
crackers whole wheat reduced fat	crackers whole wheat reduced fat
crackers whole wheat sandwich type with cheese filling	crackers whole wheat sandwich type with cheese filling
crackers whole wheat sandwich type with peanut butter filling	crackers whole wheat sandwich type with peanut butter filling
crackers rye wafers plain	crackers rye wafers plain
crackers rye wafers seasoned	crackers rye wafers seasoned
crackers rye crisp bread	crackers rye crisp bread
crackers melba toast plain	crackers melba toast plain
crackers melba toast rye includes pumpernickel	crackers melba toast rye includes pumpernickel
crackers melba toast wheat	crackers melba toast wheat
crackers matzo plain	crackers matzo plain
crackers matzo egg	crackers matzo egg
crackers matzo egg and onion	crackers matzo egg and onion
crackers matzo whole wheat	crackers matzo whole wheat
crackers milk	crackers milk
crackers standard snack type regular	crackers standard snack type regular
crackers standard snack type reduced fat	crackers standard snack type reduced fat
crackers standard snack type sandwich type with cheese filling	crackers standard snack type sandwich type with cheese filling
crackers standard snack type sandwich type with peanut butter filling	crackers standard snack type sandwich type with peanut butter filling
pretzels hard plain salted	pretzels hard plain salted
pretzels hard plain unsalted	pretzels hard plain unsalted
pretzels hard whole wheat	pretzels hard whole wheat
pretzels hard confectioner's coating chocolate flavor	pretzels hard confectioner's coating chocolate flavor
pretzels soft	pretzels soft
chips tortilla plain	chips tortilla plain
chips tortilla nacho cheese	chips tortilla nacho cheese
chips tortilla ranch	chips tortilla ranch
chips tortilla low fat baked without fat	chips tortilla low fat baked without fat
chips tortilla low fat unsalted	chips tortilla low fat unsalted
chips tortilla light sodium	chips tortilla light sodium
chips tortilla white corn	chips tortilla white corn
chips tortilla yellow corn	chips tortilla yellow corn
chips potato plain salted	chips potato plain salted
chips potato plain unsalted	chips potato plain unsalted
chips potato reduced fat	chips potato reduced fat
chips potato barbecue flavor	chips potato barbecue flavor
chips potato sour cream and onion flavor	chips potato sour cream and onion flavor
chips potato cheese flavor	chips potato cheese flavor
chips potato light	chips potato light
chips potato made from dried potatoes plain	chips potato made from dried potatoes plain
chips potato made from dried potatoes reduced fat	chips potato made from dried potatoes reduced fat
chips potato made from dried potatoes sour cream and onion flavor	chips potato made from dried potatoes sour cream and onion flavor
chips potato made from dried potatoes cheese flavor	chips potato made from dried potatoes cheese flavor
chips potato made from dried potatoes fat free	chips potato made from dried potatoes fat free
chips corn based extruded puffed or twisted corn flavor	chips corn based extruded puffed or twisted corn flavor
chips corn based extruded puffed or twisted cheese flavor	chips corn based extruded puffed or twisted cheese flavor
chips corn based extruded puffed or twisted onion flavor	chips corn based extruded puffed or twisted onion flavor
popcorn air popped	popcorn air popped
popcorn air popped white popped	popcorn air popped white popped
popcorn oil popped	popcorn oil popped
popcorn oil popped white popped	popcorn oil popped white popped
popcorn oil popped microwave regular flavor	popcorn oil popped microwave regular flavor
popcorn oil popped microwave low fat	popcorn oil popped microwave low fat
popcorn oil popped microwave low fat and sodium	popcorn oil popped microwave low fat and sodium
popcorn cakes	popcorn cakes
popcorn caramel coated without peanuts	popcorn caramel coated without peanuts
popcorn caramel coated with peanuts	popcorn caramel coated with peanuts
popcorn cheese flavor	popcorn cheese flavor
rice cakes brown rice plain	rice cakes brown rice plain
rice cakes brown rice plain unsalted	rice cakes brown rice plain unsalted
rice cakes brown rice multigrain	rice cakes brown rice multigrain
rice cakes brown rice multigrain unsalted	rice cakes brown rice multigrain unsalted
rice cakes brown rice buckwheat	rice cakes brown rice buckwheat
rice cakes brown rice buckwheat unsalted	rice cakes brown rice buckwheat unsalted
rice cakes brown rice sesame seed	rice cakes brown rice sesame seed
rice cakes brown rice sesame seed unsalted	rice cakes brown rice sesame seed unsalted
rice cakes brown rice corn	rice cakes brown rice corn
rice cakes brown rice corn unsalted	rice cakes brown rice corn unsalted
rice cakes brown rice rye	rice cakes brown rice rye
rice cakes brown rice rye unsalted	rice cakes brown rice rye unsalted
cornmeal whole grain yellow	cornmeal whole grain yellow
cornmeal whole grain white	cornmeal whole grain white
cornmeal degermed enriched yellow	cornmeal degermed enriched yellow
cornmeal degermed enriched white	cornmeal degermed enriched white
cornmeal self rising degermed enriched yellow	cornmeal self rising degermed enriched yellow
cornmeal self rising degermed enriched white	cornmeal self rising degermed enriched white
cornmeal self rising bolted plain enriched yellow	cornmeal self rising bolted plain enriched yellow
cornmeal self rising bolted plain enriched white	cornmeal self rising bolted plain enriched white
cornmeal self rising bolted with wheat flour enriched yellow	cornmeal self rising bolted with wheat flour enriched yellow
cornmeal self rising bolted with wheat flour enriched white	cornmeal self rising bolted with wheat flour enriched white
cornstarch	cornstarch
wheat flour white all purpose enriched bleached	wheat flour white all purpose enriched bleached
wheat flour white all purpose enriched unbleached	wheat flour white all purpose enriched unbleached
wheat flour white all purpose unenriched	wheat flour white all purpose unenriched
wheat flour white bread enriched	wheat flour white bread enriched
wheat flour white cake enriched	wheat flour white cake enriched
wheat flour white self rising enriched	wheat flour white self rising enriched
wheat flour whole grain	wheat flour whole grain
wheat flour whole grain soft wheat	wheat flour whole grain soft wheat
rice flour white	rice flour white
rice flour brown	rice flour brown
rye flour dark	rye flour dark
rye flour light	rye flour light
rye flour medium	rye flour medium
barley flour or meal	barley flour or meal
buckwheat flour whole groat	buckwheat flour whole groat
soy flour defatted	soy flour defatted
soy flour full fat raw	soy flour full fat raw
soy flour full fat roasted	soy flour full fat roasted
soy flour low fat	soy flour low fat
amaranth grain uncooked	amaranth grain uncooked
amaranth grain cooked	amaranth grain cooked
quinoa uncooked	quinoa uncooked
quinoa cooked	quinoa cooked
bulgur dry	bulgur dry
bulgur cooked	bulgur cooked
wheat bran crude	wheat bran crude
wheat germ crude	wheat germ crude
wheat germ toasted plain	wheat germ toasted plain
oat bran raw	oat bran raw
oat bran cooked	oat bran cooked
rice bran crude	rice bran crude
corn bran crude	corn bran crude
barley malt flour	barley malt flour
barley pearled raw	barley pearled raw
barley pearled cooked	barley pearled cooked
oats	oats
oats instant fortified plain prepared with water	oats instant fortified plain prepared with water
oats instant fortified plain dry	oats instant fortified plain dry
oats instant fortified with cinnamon and spice prepared with water	oats instant fortified with cinnamon and spice prepared with water
oats instant fortified with cinnamon and spice dry	oats instant fortified with cinnamon and spice dry
oats instant fortified with raisins and spice prepared with water	oats instant fortified with raisins and spice prepared with water
oats instant fortified with raisins and spice dry	oats instant fortified with raisins and spice dry
oats regular and quick unenriched cooked with water without salt	oats regular and quick unenriched cooked with water without salt
oats regular and quick unenriched cooked with water with salt	oats regular and quick unenriched cooked with water with salt
oats regular and quick unenriched dry	oats regular and quick unenriched dry
oats regular and quick and instant unenriched cooked with water without salt	oats regular and quick and instant unenriched cooked with water without salt
oats regular and quick and instant unenriched cooked with water with salt	oats regular and quick and instant unenriched cooked with water with salt
oats regular and quick and instant unenriched dry	oats regular and quick and instant unenriched dry
farina unenriched dry	farina unenriched dry
farina unenriched cooked with water without salt	farina unenriched cooked with water without salt
farina unenriched cooked with water with salt	farina unenriched cooked with water with salt
farina enriched dry	farina enriched dry
farina enriched cooked with water without salt	farina enriched cooked with water without salt
farina enriched cooked with water with salt	farina enriched cooked with water with salt
farina enriched cooked with water and salt	farina enriched cooked with water and salt
cream of wheat instant prepared with water without salt	cream of wheat instant prepared with water without salt
cream of wheat instant prepared with water with salt	cream of wheat instant prepared with water with salt
cream of wheat instant dry	cream of wheat instant dry
cream of wheat quick prepared with water without salt	cream of wheat quick prepared with water without salt
cream of wheat quick prepared with water with salt	cream of wheat quick prepared with water with salt
cream of wheat quick dry	cream of wheat quick dry
cream of wheat regular prepared with water without salt	cream of wheat regular prepared with water without salt
cream of wheat regular prepared with water with salt	cream of wheat regular prepared with water with salt
cream of wheat regular dry	cream of wheat regular dry
ready to eat cereal corn flakes low sodium	ready to eat cereal corn flakes low sodium
ready to eat cereal corn flakes toasted whole grain	ready to eat cereal corn flakes toasted whole grain
ready to eat cereal rice krispies kellog's	ready to eat cereal rice krispies kellog's
ready to eat cereal rice krispies kellog's gluten free	ready to eat cereal rice krispies kellog's gluten free
ready to eat cereal rice chex	ready to eat cereal rice chex
ready to eat cereal wheat chex	ready to eat cereal wheat chex
ready to eat cereal corn chex	ready to eat cereal corn chex
ready to eat cereal cheerios general mills	ready to eat cereal cheerios general mills
ready to eat cereal cheerios honey nut	ready to eat cereal cheerios honey nut
ready to eat cereal cheerios multi grain	ready to eat cereal cheerios multi grain
ready to eat cereal shredded wheat spoon size	ready to eat cereal shredded wheat spoon size
ready to eat cereal shredded wheat large biscuit	ready to eat cereal shredded wheat large biscuit
ready to eat cereal shredded wheat with raisins	ready to eat cereal shredded wheat with raisins
ready to eat cereal wheat squares	ready to eat cereal wheat squares
ready to eat cereal whole grain total	ready to eat cereal whole grain total
ready to eat cereal raisin bran	ready to eat cereal raisin bran
ready to eat cereal all bran	ready to eat cereal all bran
ready to eat cereal all bran with extra fiber	ready to eat cereal all bran with extra fiber
ready to eat cereal 100 bran	ready to eat cereal 100 bran
ready to eat cereal bran flakes	ready to eat cereal bran flakes
ready to eat cereal 40 bran flakes	ready to eat cereal 40 bran flakes
ready to eat cereal 40 bran flakes with raisins	ready to eat cereal 40 bran flakes with raisins
ready to eat cereal cracklin oat bran	ready to eat cereal cracklin oat bran
ready to eat cereal granola homemade	ready to eat cereal granola homemade
ready to eat cereal granola commercially prepared	ready to eat cereal granola commercially prepared
ready to eat cereal granola with raisins commercially prepared	ready to eat cereal granola with raisins commercially prepared