onions spring scallions includes tops bulb raw	onions spring scallions includes tops bulb raw
beef ground 75 lean meat / 25 fat patty cooked broiled	beef ground 75 lean meat / 25 fat patty cooked broiled
beef ground 80 lean meat / 20 fat patty cooked broiled	beef ground 80 lean meat / 20 fat patty cooked broiled
beef ground 85 lean meat / 15 fat patty cooked broiled	beef ground 85 lean meat / 15 fat patty cooked broiled
beef ground 90 lean meat / 10 fat patty cooked broiled	beef ground 90 lean meat / 10 fat patty cooked broiled
figs dried uncooked	figs dried uncooked
peppers hot chili red raw	peppers hot chili red raw
peppers jalapeno raw	peppers jalapeno raw
pepperoni beef pork sliced	pepperoni beef pork sliced
snacks tortilla chips plain white corn salted	snacks tortilla chips plain white corn salted
beans snap green raw	beans snap green raw
seeds sesame seed kernels dried decorticated	seeds sesame seed kernels dried decorticated
spices pepper red or cayenne	spices pepper red or cayenne
beverages tea instant unsweetened powder	beverages tea instant unsweetened powder
rice white short grain raw	rice white short grain raw
pork fresh loin top loin chops boneless separable lean fat raw	pork fresh loin top loin chops boneless separable lean fat raw
pork fresh loin top loin chops boneless separable lean fat cooked broiled	pork fresh loin top loin chops boneless separable lean fat cooked broiled
pork fresh loin top loin chops boneless separable lean only trimmed 0 fat raw	pork fresh loin top loin chops boneless separable lean only trimmed 0 fat raw
pork fresh loin top loin chops boneless separable lean only trimmed 0 fat cooked broiled	pork fresh loin top loin chops boneless separable lean only trimmed 0 fat cooked broiled
pork fresh loin top loin chops bone in separable lean fat raw	pork fresh loin top loin chops bone in separable lean fat raw
pork fresh loin top loin chops bone in separable lean fat cooked broiled	pork fresh loin top loin chops bone in separable lean fat cooked broiled
pork fresh loin top loin chops bone in separable lean only trimmed 0 fat raw	pork fresh loin top loin chops bone in separable lean only trimmed 0 fat raw
pork fresh loin top loin chops bone in separable lean only trimmed 0 fat cooked broiled	pork fresh loin top loin chops bone in separable lean only trimmed 0 fat cooked broiled
pork fresh loin center rib chops boneless separable lean fat raw	pork fresh loin center rib chops boneless separable lean fat raw
pork fresh loin center rib chops boneless separable lean fat cooked broiled	pork fresh loin center rib chops boneless separable lean fat cooked broiled
pork fresh loin center rib chops boneless separable lean only trimmed 0 fat raw	pork fresh loin center rib chops boneless separable lean only trimmed 0 fat raw
pork fresh loin center rib chops boneless separable lean only trimmed 0 fat cooked broiled	pork fresh loin center rib chops boneless separable lean only trimmed 0 fat cooked broiled
pork fresh loin center rib chops bone in separable lean fat raw	pork fresh loin center rib chops bone in separable lean fat raw
pork fresh loin center rib chops bone in separable lean fat cooked broiled	pork fresh loin center rib chops bone in separable lean fat cooked broiled
pork fresh loin center rib chops bone in separable lean only trimmed 0 fat raw	pork fresh loin center rib chops bone in separable lean only trimmed 0 fat raw
pork fresh loin center rib chops bone in separable lean only trimmed 0 fat cooked broiled	pork fresh loin center rib chops bone in separable lean only trimmed 0 fat cooked broiled
pork fresh loin center loin chops boneless separable lean fat raw	pork fresh loin center loin chops boneless separable lean fat raw
pork fresh loin center loin chops boneless separable lean fat cooked broiled	pork fresh loin center loin chops boneless separable lean fat cooked broiled
pork fresh loin center loin chops boneless separable lean only trimmed 0 fat raw	pork fresh loin center loin chops boneless separable lean only trimmed 0 fat raw
pork fresh loin center loin chops boneless separable lean only trimmed 0 fat cooked broiled	pork fresh loin center loin chops boneless separable lean only trimmed 0 fat cooked broiled
pork fresh loin center loin chops bone in separable lean fat raw	pork fresh loin center loin chops bone in separable lean fat raw
pork fresh loin center loin chops bone in separable lean fat cooked broiled	pork fresh loin center loin chops bone in separable lean fat cooked broiled
pork fresh loin center loin chops bone in separable lean only trimmed 0 fat raw	pork fresh loin center loin chops bone in separable lean only trimmed 0 fat raw
pork fresh loin center loin chops bone in separable lean only trimmed 0 fat cooked broiled	pork fresh loin center loin chops bone in separable lean only trimmed 0 fat cooked broiled
pork fresh loin sirloin chops boneless separable lean fat raw	pork fresh loin sirloin chops boneless separable lean fat raw
pork fresh loin sirloin chops boneless separable lean fat cooked broiled	pork fresh loin sirloin chops boneless separable lean fat cooked broiled
pork fresh loin sirloin chops boneless separable lean only trimmed 0 fat raw	pork fresh loin sirloin chops boneless separable lean only trimmed 0 fat raw
pork fresh loin sirloin chops boneless separable lean only trimmed 0 fat cooked broiled	pork fresh loin sirloin chops boneless separable lean only trimmed 0 fat cooked broiled
pork fresh loin sirloin chops bone in separable lean fat raw	pork fresh loin sirloin chops bone in separable lean fat raw
pork fresh loin sirloin chops bone in separable lean fat cooked broiled	pork fresh loin sirloin chops bone in separable lean fat cooked broiled
pork fresh loin sirloin chops bone in separable lean only trimmed 0 fat raw	pork fresh loin sirloin chops bone in separable lean only trimmed 0 fat raw
pork fresh loin sirloin chops bone in separable lean only trimmed 0 fat cooked broiled	pork fresh loin sirloin chops bone in separable lean only trimmed 0 fat cooked broiled
pork fresh loin blade chops boneless separable lean fat raw	pork fresh loin blade chops boneless separable lean fat raw
pork fresh loin blade chops boneless separable lean fat cooked broiled	pork fresh loin blade chops boneless separable lean fat cooked broiled
pork fresh loin blade chops boneless separable lean only trimmed 0 fat raw	pork fresh loin blade chops boneless separable lean only trimmed 0 fat raw
pork fresh loin blade chops boneless separable lean only trimmed 0 fat cooked broiled	pork fresh loin blade chops boneless separable lean only trimmed 0 fat cooked broiled
pork fresh loin blade chops bone in separable lean fat raw	pork fresh loin blade chops bone in separable lean fat raw
pork fresh loin blade chops bone in separable lean fat cooked broiled	pork fresh loin blade chops bone in separable lean fat cooked broiled
pork fresh loin blade chops bone in separable lean only trimmed 0 fat raw	pork fresh loin blade chops bone in separable lean only trimmed 0 fat raw
pork fresh loin blade chops bone in separable lean only trimmed 0 fat cooked broiled	pork fresh loin blade chops bone in separable lean only trimmed 0 fat cooked broiled
pork fresh loin tenderloin separable lean fat raw	pork fresh loin tenderloin separable lean fat raw
pork fresh loin tenderloin separable lean fat cooked broiled	pork fresh loin tenderloin separable lean fat cooked broiled
pork fresh loin tenderloin separable lean only trimmed 0 fat raw	pork fresh loin tenderloin separable lean only trimmed 0 fat raw
pork fresh loin tenderloin separable lean only trimmed 0 fat cooked broiled	pork fresh loin tenderloin separable lean only trimmed 0 fat cooked broiled
pork fresh loin country style ribs separable lean fat raw	pork fresh loin country style ribs separable lean fat raw
pork fresh loin country style ribs separable lean fat cooked broiled	pork fresh loin country style ribs separable lean fat cooked broiled
pork fresh loin country style ribs separable lean only trimmed 0 fat raw	pork fresh loin country style ribs separable lean only trimmed 0 fat raw
pork fresh loin country style ribs separable lean only trimmed 0 fat cooked broiled	pork fresh loin country style ribs separable lean only trimmed 0 fat cooked broiled
nuts cashew nuts dry roasted without salt added	nuts cashew nuts dry roasted without salt added
nuts brazilnuts dried unblanched	nuts brazilnuts dried unblanched
nuts hazelnuts filberts	nuts hazelnuts filberts
nuts pecans	nuts pecans
nuts pistachio nuts dry roasted without salt added	nuts pistachio nuts dry roasted without salt added
nuts walnuts english	nuts walnuts english
nuts almonds	nuts almonds
nuts chestnuts european roasted	nuts chestnuts european roasted
nuts coconut meat raw	nuts coconut meat raw
nuts coconut meat dried desiccated sweetened flaked packaged	nuts coconut meat dried desiccated sweetened flaked packaged
nuts coconut meat dried desiccated sweetened shredded	nuts coconut meat dried desiccated sweetened shredded
nuts macadamia nuts dry roasted without salt added	nuts macadamia nuts dry roasted without salt added
nuts pine nuts dried	nuts pine nuts dried
nuts mixed nuts without peanuts oil roasted without salt added	nuts mixed nuts without peanuts oil roasted without salt added
nuts mixed nuts with peanuts oil roasted without salt added	nuts mixed nuts with peanuts oil roasted without salt added
peanuts all types oil roasted without salt	peanuts all types oil roasted without salt
peanuts all types oil roasted with salt	peanuts all types oil roasted with salt
peanuts all types raw	peanuts all types raw
peanuts all types dry roasted without salt	peanuts all types dry roasted without salt
peanuts all types dry roasted with salt	peanuts all types dry roasted with salt
peanut butter smooth style with salt	peanut butter smooth style with salt
peanut butter smooth style without salt	peanut butter smooth style without salt
peanut butter chunky style with salt	peanut butter chunky style with salt
peanut butter chunky style without salt	peanut butter chunky style without salt
seeds sunflower seed kernels dry roasted without salt	seeds sunflower seed kernels dry roasted without salt
seeds sunflower seed kernels dry roasted with salt	seeds sunflower seed kernels dry roasted with salt
seeds sunflower seed kernels oil roasted without salt	seeds sunflower seed kernels oil roasted without salt
seeds sunflower seed kernels oil roasted with salt	seeds sunflower seed kernels oil roasted with salt
seeds pumpkin and squash seed kernels roasted without salt	seeds pumpkin and squash seed kernels roasted without salt
seeds pumpkin and squash seed kernels roasted with salt	seeds pumpkin and squash seed kernels roasted with salt
seeds pumpkin and squash seed kernels dried	seeds pumpkin and squash seed kernels dried
seeds flaxseed	seeds flaxseed
seeds chia seeds dried	seeds chia seeds dried
oil olive salad or cooking	oil olive salad or cooking
oil canola	oil canola
oil corn industrial and retail all purpose salad or cooking	oil corn industrial and retail all purpose salad or cooking
oil coconut	oil coconut
oil sesame salad or cooking	oil sesame salad or cooking
oil sunflower linoleic high oleic 70 and over	oil sunflower linoleic high oleic 70 and over
oil peanut salad or cooking	oil peanut salad or cooking
oil safflower salad or cooking oleic over 70	oil safflower salad or cooking oleic over 70
oil soybean salad or cooking	oil soybean salad or cooking
oil vegetable natreon canola high stability non trans high oleic	oil vegetable natreon canola high stability non trans high oleic
margarine regular 80 fat composite stick without salt	margarine regular 80 fat composite stick without salt
margarine regular 80 fat composite stick with salt unsalted	margarine regular 80 fat composite stick with salt unsalted
margarine regular 80 fat composite tub without salt	margarine regular 80 fat composite tub without salt
margarine regular 80 fat composite tub with salt	margarine regular 80 fat composite tub with salt
margarine like spread with yogurt 70 fat stick without salt	margarine like spread with yogurt 70 fat stick without salt
margarine like spread with yogurt 70 fat stick with salt	margarine like spread with yogurt 70 fat stick with salt
margarine like spread with yogurt approximately 40 fat tub with salt	margarine like spread with yogurt approximately 40 fat tub with salt
margarine like spread smart balance omega plus light buttery spread	margarine like spread smart balance omega plus light buttery spread
margarine like spread smart balance light buttery spread	margarine like spread smart balance light buttery spread
margarine like spread smart balance regular buttery spread with flax oil	margarine like spread smart balance regular buttery spread with flax oil
margarine like spread smart balance 67 buttery spread	margarine like spread smart balance 67 buttery spread
margarine like spread benecol regular	margarine like spread benecol regular
margarine like spread benecol light	margarine like spread benecol light
margarine like spread take control	margarine like spread take control
butter salted	butter salted
butter without salt	butter without salt
butter whipped with salt	butter whipped with salt
butter whipped without salt	butter whipped without salt
butter light stick salted	butter light stick salted
butter light stick without salt	butter light stick without salt
shortening household soybean cottonseed and soybean	shortening household soybean cottonseed and soybean
shortening frying heavy duty beef tallow and cottonseed	shortening frying heavy duty beef tallow and cottonseed
shortening confectionery coconut hard	shortening confectionery coconut hard
shortening confectionery fractionated palm	shortening confectionery fractionated palm
shortening cake mix soybean cottonseed	shortening cake mix soybean cottonseed
lard	lard
chicken fat	chicken fat
beef tallow	beef tallow
duck and goose fat	duck and goose fat
turkey fat	turkey fat
salad dressing ranch dressing regular	salad dressing ranch dressing regular
salad dressing ranch dressing reduced fat	salad dressing ranch dressing reduced fat
salad dressing ranch dressing fat free	salad dressing ranch dressing fat free
salad dressing caesar dressing regular	salad dressing caesar dressing regular
salad dressing caesar dressing low calorie	salad dressing caesar dressing low calorie
salad dressing italian dressing regular	salad dressing italian dressing regular
salad dressing italian dressing reduced fat	salad dressing italian dressing reduced fat
salad dressing italian dressing fat free	salad dressing italian dressing fat free
salad dressing thousand island dressing regular	salad dressing thousand island dressing regular
salad dressing thousand island dressing reduced fat	salad dressing thousand island dressing reduced fat
salad dressing french dressing regular	salad dressing french dressing regular
salad dressing french dressing reduced fat	salad dressing french dressing reduced fat
salad dressing blue cheese dressing regular	salad dressing blue cheese dressing regular
salad dressing blue cheese dressing reduced fat	salad dressing blue cheese dressing reduced fat
salad dressing coleslaw dressing	salad dressing coleslaw dressing
salad dressing green goddess dressing regular	salad dressing green goddess dressing regular
salad dressing honey mustard dressing	salad dressing honey mustard dressing
salad dressing mayonnaise dressing no cholesterol	salad dressing mayonnaise dressing no cholesterol
salad dressing mayonnaise type soybean oil with salt	salad dressing mayonnaise type soybean oil with salt
salad dressing mayonnaise type soybean oil without salt	salad dressing mayonnaise type soybean oil without salt
salad dressing mayonnaise type soybean and safflower oil with salt	salad dressing mayonnaise type soybean and safflower oil with salt
salad dressing mayonnaise type soybean and safflower oil without salt	salad dressing mayonnaise type soybean and safflower oil without salt
salad dressing mayonnaise regular	salad dressing mayonnaise regular
salad dressing mayonnaise reduced fat	salad dressing mayonnaise reduced fat
salad dressing mayonnaise fat free	salad dressing mayonnaise fat free
salad dressing peppercorn dressing regular	salad dressing peppercorn dressing regular
salad dressing russian dressing	salad dressing russian dressing
salad dressing russian dressing low calorie	salad dressing russian dressing low calorie
salad dressing sesame seed dressing regular	salad dressing sesame seed dressing regular
salad dressing vinaigrette	salad dressing vinaigrette
vinegar cider	vinegar cider
vinegar distilled	vinegar distilled
vinegar red wine	vinegar red wine
vinegar balsamic	vinegar balsamic
sauce mustard prepared yellow	sauce mustard prepared yellow
sauce mustard prepared brown	sauce mustard prepared brown
sauce horseradish prepared	sauce horseradish prepared
sauce worcestershire	sauce worcestershire
sauce soy made from soy and wheat shoyu	sauce soy made from soy and wheat shoyu
sauce soy made from soy hydrolyzed vegetable protein	sauce soy made from soy hydrolyzed vegetable protein
sauce soy made from soy reduced sodium	sauce soy made from soy reduced sodium
sauce teriyaki ready to serve	sauce teriyaki ready to serve
sauce sweet and sour ready to serve	sauce sweet and sour ready to serve
sauce barbecue	sauce barbecue
sauce marinara ready to serve	sauce marinara ready to serve
sauce pasta spaghetti marinara ready to serve	sauce pasta spaghetti marinara ready to serve
sauce pasta spaghetti marinara ready to serve low sodium	sauce pasta spaghetti marinara ready to serve low sodium
sauce tomato spanish style	sauce tomato spanish style
sauce tomato canned no salt added	sauce tomato canned no salt added
sauce tomato canned	sauce tomato canned
sauce hollandaise dehydrated prepared with water	sauce hollandaise dehydrated prepared with water
sauce hollandaise dehydrated dry	sauce hollandaise dehydrated dry
sauce cheese ready to serve	sauce cheese ready to serve
sauce cheese nacho cheese ready to serve	sauce cheese nacho cheese ready to serve
sauce plum ready to serve	sauce plum ready to serve
sauce duck ready to serve	sauce duck ready to serve
sauce fish ready to serve	sauce fish ready to serve
sauce hoisin ready to serve	sauce hoisin ready to serve
sauce oyster ready to serve	sauce oyster ready to serve
sauce chili garlic ready to serve	sauce chili garlic ready to serve
sauce tabasco	sauce tabasco
sauce hot pepper	sauce hot pepper
catsup	catsup
catsup low sodium	catsup low sodium
pickle cucumber dill	pickle cucumber dill
pickle cucumber sweet includes bread and butter pickles	pickle cucumber sweet includes bread and butter pickles
pickle cucumber sour	pickle cucumber sour
pickle relish hamburger	pickle relish hamburger
pickle relish hotdog	pickle relish hotdog
pickle relish sweet	pickle relish sweet
olives pickled canned or bottled green	olives pickled canned or bottled green
olives ripe canned small extra large	olives ripe canned small extra large
capers canned	capers canned
soup stock beef home prepared	soup stock beef home prepared
soup stock chicken home prepared	soup stock chicken home prepared
soup stock fish home prepared	soup stock fish home prepared
soup stock vegetable home prepared	soup stock vegetable home prepared
soup bouillon cubes dry	soup bouillon cubes dry
soup ramen noodle any flavor dry	soup ramen noodle any flavor dry
soup ramen noodle beef flavor dry	soup ramen noodle beef flavor dry
soup ramen noodle chicken flavor dry	soup ramen noodle chicken flavor dry
soup onion dehydrated	soup onion dehydrated
soup onion dehydrated prepared with water	soup onion dehydrated prepared with water
soup tomato dehydrated	soup tomato dehydrated
soup tomato dehydrated prepared with water	soup tomato dehydrated prepared with water
soup chicken noodle dehydrated	soup chicken noodle dehydrated
soup chicken noodle dehydrated prepared with water	soup chicken noodle dehydrated prepared with water
soup vegetable beef dehydrated	soup vegetable beef dehydrated
soup vegetable beef dehydrated prepared with water	soup vegetable beef dehydrated prepared with water
soup bean with bacon dehydrated	soup bean with bacon dehydrated
soup bean with bacon dehydrated prepared with water	soup bean with bacon dehydrated prepared with water
soup cream of mushroom dehydrated	soup cream of mushroom dehydrated
soup cream of mushroom dehydrated prepared with water	soup cream of mushroom dehydrated prepared with water
soup cream of chicken dehydrated	soup cream of chicken dehydrated
soup cream of chicken dehydrated prepared with water	soup cream of chicken dehydrated prepared with water