lasagna with meat & sauce frozen entree	lasagna with meat & sauce frozen entree
bread oatmeal	bread oatmeal
salad dressing mayonnaise light	salad dressing mayonnaise light
salad dressing poppyseed creamy	salad dressing poppyseed creamy
gelatin desserts dry mix reduced calorie with aspartame prepared with water	gelatin desserts dry mix reduced calorie with aspartame prepared with water
bread white commercially prepared	bread white commercially prepared
bread white commercially prepared toasted	bread white commercially prepared toasted
bread white commercially prepared low sodium	bread white commercially prepared low sodium
bread white commercially prepared low sodium toasted	bread white commercially prepared low sodium toasted
bread whole wheat commercially prepared	bread whole wheat commercially prepared
bread whole wheat commercially prepared toasted	bread whole wheat commercially prepared toasted
bread mixed grain commercial	bread mixed grain commercial
bread mixed grain commercial toasted	bread mixed grain commercial toasted
bread rye	bread rye
bread rye toasted	bread rye toasted
bread pumpernickel	bread pumpernickel
bread pumpernickel toasted	bread pumpernickel toasted
bread sourdough	bread sourdough
bread sourdough toasted	bread sourdough toasted
bread french or vienna includes sourdough	bread french or vienna includes sourdough
bread french or vienna includes sourdough toasted	bread french or vienna includes sourdough toasted
bread italian	bread italian
bread italian toasted	bread italian toasted
bread pita white	bread pita white
bread pita whole wheat	bread pita whole wheat
bread roll dinner plain commercial	bread roll dinner plain commercial
bread roll dinner plain commercial toasted	bread roll dinner plain commercial toasted
bread roll dinner whole wheat commercial	bread roll dinner whole wheat commercial
bread roll dinner whole wheat commercial toasted	bread roll dinner whole wheat commercial toasted
bread roll hard including kaiser	bread roll hard including kaiser
bread roll hard including kaiser toasted	bread roll hard including kaiser toasted
bread roll hamburger or hotdog plain	bread roll hamburger or hotdog plain
bread roll hamburger or hotdog plain toasted	bread roll hamburger or hotdog plain toasted
bread roll hamburger or hotdog whole wheat	bread roll hamburger or hotdog whole wheat
bread roll hamburger or hotdog whole wheat toasted	bread roll hamburger or hotdog whole wheat toasted
bread roll sweet	bread roll sweet
bread roll sweet toasted	bread roll sweet toasted
bread sticks plain	bread sticks plain
bread crumbs dry grated seasoned	bread crumbs dry grated seasoned
bread crumbs dry grated plain	bread crumbs dry grated plain
bread stuffing mix dry	bread stuffing mix dry
bread stuffing mix dry prepared	bread stuffing mix dry prepared
croissant plain	croissant plain
croissant cheese	croissant cheese
croissant apple	croissant apple
croissant almond	croissant almond
croissant chocolate	croissant chocolate
danish pastry plain	danish pastry plain
danish pastry cheese	danish pastry cheese
danish pastry fruit	danish pastry fruit
danish pastry cinnamon	danish pastry cinnamon
danish pastry nut	danish pastry nut
sweet roll cinnamon commercially prepared	sweet roll cinnamon commercially prepared
sweet roll cinnamon with raisins commercially prepared	sweet roll cinnamon with raisins commercially prepared
doughnuts cake type plain including sugared old fashioned	doughnuts cake type plain including sugared old fashioned
doughnuts cake type plain chocolate coated or frosted	doughnuts cake type plain chocolate coated or frosted
doughnuts cake type wheat including sugared old fashioned	doughnuts cake type wheat including sugared old fashioned
doughnuts cake type chocolate including sugared old fashioned	doughnuts cake type chocolate including sugared old fashioned
doughnuts yeast leavened plain	doughnuts yeast leavened plain
doughnuts yeast leavened glazed enriched all purpose flour	doughnuts yeast leavened glazed enriched all purpose flour
doughnuts yeast leavened glazed enriched all purpose flour reduced fat	doughnuts yeast leavened glazed enriched all purpose flour reduced fat
doughnuts yeast leavened with creme filling	doughnuts yeast leavened with creme filling
doughnuts yeast leavened with jelly filling	doughnuts yeast leavened with jelly filling
toaster pastries fruit filled	toaster pastries fruit filled
toaster pastries fruit filled frosted	toaster pastries fruit filled frosted
toaster pastries brown sugar cinnamon	toaster pastries brown sugar cinnamon
toaster pastries brown sugar cinnamon frosted	toaster pastries brown sugar cinnamon frosted
toaster pastries chocolate fudge	toaster pastries chocolate fudge
toaster pastries chocolate fudge frosted	toaster pastries chocolate fudge frosted
toaster pastries s'mores	toaster pastries s'mores
toaster pastries s'mores frosted	toaster pastries s'mores frosted
english muffin plain	english muffin plain
english muffin plain toasted	english muffin plain toasted
english muffin whole wheat	english muffin whole wheat
english muffin whole wheat toasted	english muffin whole wheat toasted
english muffin raisin cinnamon includes apple cinnamon	english muffin raisin cinnamon includes apple cinnamon
english muffin raisin cinnamon includes apple cinnamon toasted	english muffin raisin cinnamon includes apple cinnamon toasted
english muffin sourdough	english muffin sourdough
english muffin sourdough toasted	english muffin sourdough toasted
bagel plain	bagel plain
bagel plain toasted	bagel plain toasted
bagel whole grain	bagel whole grain
bagel whole grain toasted	bagel whole grain toasted
bagel cinnamon raisin	bagel cinnamon raisin
bagel cinnamon raisin toasted	bagel cinnamon raisin toasted
bagel egg	bagel egg
bagel egg toasted	bagel egg toasted
bagel onion	bagel onion
bagel onion toasted	bagel onion toasted
bagel poppy seed	bagel poppy seed
bagel poppy seed toasted	bagel poppy seed toasted
bagel sesame	bagel sesame
bagel sesame toasted	bagel sesame toasted
bagel oat bran	bagel oat bran
bagel oat bran toasted	bagel oat bran toasted
muffin plain	muffin plain
muffin blueberry	muffin blueberry
muffin oat bran	muffin oat bran
muffin banana	muffin banana
muffin bran	muffin bran
muffin corn	muffin corn
muffin apple	muffin apple
muffin chocolate chip	muffin chocolate chip
muffin lemon	muffin lemon
muffin cranberry	muffin cranberry
muffin carrot	muffin carrot
muffin pumpkin	muffin pumpkin
muffin raisin	muffin raisin
muffin blueberry low fat	muffin blueberry low fat
muffin apple low fat	muffin apple low fat
muffin banana low fat	muffin banana low fat
muffin bran low fat	muffin bran low fat
muffin corn low fat	muffin corn low fat
muffin cranberry low fat	muffin cranberry low fat
muffin oat bran low fat	muffin oat bran low fat
muffin plain low fat	muffin plain low fat
muffin raisin low fat	muffin raisin low fat
biscuit plain or buttermilk commercially prepared	biscuit plain or buttermilk commercially prepared
biscuit plain or buttermilk refrigerated dough higher fat	biscuit plain or buttermilk refrigerated dough higher fat
biscuit plain or buttermilk refrigerated dough lower fat	biscuit plain or buttermilk refrigerated dough lower fat
biscuit plain or buttermilk frozen	biscuit plain or buttermilk frozen
biscuit plain or buttermilk dry mix	biscuit plain or buttermilk dry mix
biscuit plain or buttermilk dry mix prepared	biscuit plain or buttermilk dry mix prepared
biscuit cheese	biscuit cheese
biscuit egg	biscuit egg
biscuit egg and cheese	biscuit egg and cheese
biscuit egg and bacon	biscuit egg and bacon
biscuit egg and sausage	biscuit egg and sausage
biscuit egg cheese and bacon	biscuit egg cheese and bacon
biscuit egg cheese and ham	biscuit egg cheese and ham
biscuit egg cheese and sausage	biscuit egg cheese and sausage
biscuit ham	biscuit ham
biscuit ham and cheese	biscuit ham and cheese
biscuit sausage	biscuit sausage
biscuit steak	biscuit steak
cornbread dry mix	cornbread dry mix
cornbread dry mix prepared	cornbread dry mix prepared
cornbread whole kernel	cornbread whole kernel
hush puppies	hush puppies
taco shells baked	taco shells baked
taco shells baked without added salt	taco shells baked without added salt
tortilla corn	tortilla corn
tortilla corn without added salt	tortilla corn without added salt
tortilla flour	tortilla flour
tortilla flour without added salt	tortilla flour without added salt
tortilla whole wheat	tortilla whole wheat
waffles plain frozen	waffles plain frozen
waffles plain frozen toasted	waffles plain frozen toasted
waffles plain frozen low fat	waffles plain frozen low fat
waffles plain frozen low fat toasted	waffles plain frozen low fat toasted
waffles buttermilk frozen	waffles buttermilk frozen
waffles buttermilk frozen toasted	waffles buttermilk frozen toasted
waffles whole grain frozen	waffles whole grain frozen
waffles whole grain frozen toasted	waffles whole grain frozen toasted
waffles homestyle frozen	waffles homestyle frozen
waffles homestyle frozen toasted	waffles homestyle frozen toasted
waffles low fat frozen	waffles low fat frozen
waffles low fat frozen toasted	waffles low fat frozen toasted
waffles oat bran frozen	waffles oat bran frozen
waffles oat bran frozen toasted	waffles oat bran frozen toasted
waffles blueberry frozen	waffles blueberry frozen
waffles blueberry frozen toasted	waffles blueberry frozen toasted
waffles apple cinnamon frozen	waffles apple cinnamon frozen
waffles apple cinnamon frozen toasted	waffles apple cinnamon frozen toasted
waffles strawberry frozen	waffles strawberry frozen
waffles strawberry frozen toasted	waffles strawberry frozen toasted
waffles multi grain frozen	waffles multi grain frozen
waffles multi grain frozen toasted	waffles multi grain frozen toasted
pancakes plain frozen	pancakes plain frozen
pancakes plain frozen toasted	pancakes plain frozen toasted
pancakes buttermilk frozen	pancakes buttermilk frozen
pancakes buttermilk frozen toasted	pancakes buttermilk frozen toasted
pancakes blueberry frozen	pancakes blueberry frozen
pancakes blueberry frozen toasted	pancakes blueberry frozen toasted
pancakes whole wheat frozen	pancakes whole wheat frozen
pancakes whole wheat frozen toasted	pancakes whole wheat frozen toasted
pancakes low fat frozen	pancakes low fat frozen
pancakes low fat frozen toasted	pancakes low fat frozen toasted
pancakes plain dry mix	pancakes plain dry mix
pancakes plain dry mix prepared	pancakes plain dry mix prepared
pancakes buttermilk dry mix	pancakes buttermilk dry mix
pancakes buttermilk dry mix prepared	pancakes buttermilk dry mix prepared
pancakes whole wheat dry mix	pancakes whole wheat dry mix
pancakes whole wheat dry mix prepared	pancakes whole wheat dry mix prepared
pancakes buckwheat dry mix	pancakes buckwheat dry mix
pancakes buckwheat dry mix prepared	pancakes buckwheat dry mix prepared
french toast frozen	french toast frozen
french toast frozen toasted	french toast frozen toasted
french toast sticks frozen	french toast sticks frozen
french toast sticks frozen toasted	french toast sticks frozen toasted
crepes plain	crepes plain
crepes fruit filled	crepes fruit filled
crepes cheese filled	crepes cheese filled
crepes meat filled	crepes meat filled
crepes vegetable filled	crepes vegetable filled
syrup maple	syrup maple
syrup pancake	syrup pancake
syrup pancake lite	syrup pancake lite
syrup pancake reduced calorie	syrup pancake reduced calorie
syrup corn light	syrup corn light
syrup corn dark	syrup corn dark
honey	honey
honey strained or extracted	honey strained or extracted
molasses	molasses
molasses blackstrap	molasses blackstrap
sugar white granulated	sugar white granulated
sugar brown	sugar brown
sugar brown packed	sugar brown packed
sugar confectioner's powdered	sugar confectioner's powdered
sugar raw	sugar raw
sugar turbinado	sugar turbinado
sugar maple	sugar maple
sweetener artificial aspartame	sweetener artificial aspartame
sweetener artificial saccharin	sweetener artificial saccharin
sweetener artificial sucralose	sweetener artificial sucralose
sweetener artificial acesulfame potassium	sweetener artificial acesulfame potassium
sweetener artificial neotame	sweetener artificial neotame
sweetener artificial tabletop blend of multiple artificial sweeteners	sweetener artificial tabletop blend of multiple artificial sweeteners
sweetener stevia	sweetener stevia
jams and preserves	jams and preserves
jams and preserves apricot	jams and preserves apricot
jams and preserves grape	jams and preserves grape
jams and preserves orange marmalade	jams and preserves orange marmalade
jams and preserves strawberry	jams and preserves strawberry
jams and preserves mixed fruit	jams and preserves mixed fruit
jams and preserves peach	jams and preserves peach
jams and preserves raspberry	jams and preserves raspberry
jams and preserves blackberry	jams and preserves blackberry
jams and preserves cherry	jams and preserves cherry
jams and preserves plum	jams and preserves plum
jams and preserves reduced sugar	jams and preserves reduced sugar
jams and preserves dietetic	jams and preserves dietetic
jellies	jellies
jellies grape	jellies grape
jellies apple	jellies apple
jellies strawberry	jellies strawberry
jellies mixed fruit	jellies mixed fruit
jellies reduced sugar	jellies reduced sugar
jellies dietetic	jellies dietetic
tomato products canned paste without salt added	tomato products canned paste without salt added
apples dried sulfured uncooked	apples dried sulfured uncooked
fish pompano florida raw	fish pompano florida raw
sauce steak tomato based	sauce steak tomato based
cranberry apple juice drink low calorie with vitamin c added	cranberry apple juice drink low calorie with vitamin c added