cheese muenster	cheese muenster
cheese cottage creamed large small curd	cheese cottage creamed large small curd
milk dry nonfat regular with added vitamin a vitamin d	milk dry nonfat regular with added vitamin a vitamin d
cream fluid light coffee cream table cream	cream fluid light coffee cream table cream
dessert topping semi solid frozen	dessert topping semi solid frozen
milk whole 3.25 milkfat	milk whole 3.25 milkfat
milk reduced fat 2 milkfat	milk reduced fat 2 milkfat
milk lowfat 1 milkfat	milk lowfat 1 milkfat
milk nonfat skim	milk nonfat skim
milk chocolate whole	milk chocolate whole
milk chocolate reduced fat 2 milkfat	milk chocolate reduced fat 2 milkfat
milk chocolate lowfat 1 milkfat	milk chocolate lowfat 1 milkfat
milk chocolate nonfat	milk chocolate nonfat
milk buttermilk	milk buttermilk
milk evaporated whole	milk evaporated whole
milk evaporated nonfat	milk evaporated nonfat
milk condensed sweetened	milk condensed sweetened
milk dry whole	milk dry whole
milk dry nonfat instant	milk dry nonfat instant
milk dry nonfat regular	milk dry nonfat regular
milk goat	milk goat
milk sheep	milk sheep
milk buffalo	milk buffalo
milk human	milk human
milk soy	milk soy
milk rice	milk rice
milk almond	milk almond
milk coconut	milk coconut
milk oat	milk oat
milk cashew	milk cashew
milk pea	milk pea
milk hemp	milk hemp
milk flax	milk flax
cream heavy whipping	cream heavy whipping
cream light whipping	cream light whipping
cream sour	cream sour
cream sour light	cream sour light
cream sour nonfat	cream sour nonfat
cream half and half	cream half and half
cream half and half fat free	cream half and half fat free
cream cheese	cream cheese
cream cheese light	cream cheese light
cream cheese fat free	cream cheese fat free
cream cheese flavored	cream cheese flavored
cream cheese whipped	cream cheese whipped
cream cheese neufchatel	cream cheese neufchatel
butter	butter
butter salted	butter salted
butter unsalted	butter unsalted
butter whipped	butter whipped
butter light	butter light
butter cultured	butter cultured
butter clarified	butter clarified
ghee	ghee
yogurt plain whole milk	yogurt plain whole milk
yogurt plain low fat	yogurt plain low fat
yogurt plain nonfat	yogurt plain nonfat
yogurt vanilla whole milk	yogurt vanilla whole milk
yogurt vanilla low fat	yogurt vanilla low fat
yogurt vanilla nonfat	yogurt vanilla nonfat
yogurt strawberry whole milk	yogurt strawberry whole milk
yogurt strawberry low fat	yogurt strawberry low fat
yogurt strawberry nonfat	yogurt strawberry nonfat
yogurt peach whole milk	yogurt peach whole milk
yogurt peach low fat	yogurt peach low fat
yogurt peach nonfat	yogurt peach nonfat
yogurt blueberry whole milk	yogurt blueberry whole milk
yogurt blueberry low fat	yogurt blueberry low fat
yogurt blueberry nonfat	yogurt blueberry nonfat
yogurt raspberry whole milk	yogurt raspberry whole milk
yogurt raspberry low fat	yogurt raspberry low fat
yogurt raspberry nonfat	yogurt raspberry nonfat
yogurt cherry whole milk	yogurt cherry whole milk
yogurt cherry low fat	yogurt cherry low fat
yogurt cherry nonfat	yogurt cherry nonfat
yogurt mixed berry whole milk	yogurt mixed berry whole milk
yogurt mixed berry low fat	yogurt mixed berry low fat
yogurt mixed berry nonfat	yogurt mixed berry nonfat
yogurt banana whole milk	yogurt banana whole milk
yogurt banana low fat	yogurt banana low fat
yogurt banana nonfat	yogurt banana nonfat
yogurt lemon whole milk	yogurt lemon whole milk
yogurt lemon low fat	yogurt lemon low fat
yogurt lemon nonfat	yogurt lemon nonfat
yogurt orange whole milk	yogurt orange whole milk
yogurt orange low fat	yogurt orange low fat
yogurt orange nonfat	yogurt orange nonfat
yogurt coconut whole milk	yogurt coconut whole milk
yogurt coconut low fat	yogurt coconut low fat
yogurt coconut nonfat	yogurt coconut nonfat
yogurt greek plain whole milk	yogurt greek plain whole milk
yogurt greek plain low fat	yogurt greek plain low fat
yogurt greek plain nonfat	yogurt greek plain nonfat
yogurt greek vanilla whole milk	yogurt greek vanilla whole milk
yogurt greek vanilla low fat	yogurt greek vanilla low fat
yogurt greek vanilla nonfat	yogurt greek vanilla nonfat
yogurt greek strawberry whole milk	yogurt greek strawberry whole milk
yogurt greek strawberry low fat	yogurt greek strawberry low fat
yogurt greek strawberry nonfat	yogurt greek strawberry nonfat
yogurt greek blueberry whole milk	yogurt greek blueberry whole milk
yogurt greek blueberry low fat	yogurt greek blueberry low fat
yogurt greek blueberry nonfat	yogurt greek blueberry nonfat
yogurt greek honey whole milk	yogurt greek honey whole milk
yogurt greek honey low fat	yogurt greek honey low fat
yogurt greek honey nonfat	yogurt greek honey nonfat
yogurt greek peach whole milk	yogurt greek peach whole milk
yogurt greek peach low fat	yogurt greek peach low fat
yogurt greek peach nonfat	yogurt greek peach nonfat
yogurt greek raspberry whole milk	yogurt greek raspberry whole milk
yogurt greek raspberry low fat	yogurt greek raspberry low fat
yogurt greek raspberry nonfat	yogurt greek raspberry nonfat
yogurt greek cherry whole milk	yogurt greek cherry whole milk
yogurt greek cherry low fat	yogurt greek cherry low fat
yogurt greek cherry nonfat	yogurt greek cherry nonfat
yogurt greek mixed berry whole milk	yogurt greek mixed berry whole milk
yogurt greek mixed berry low fat	yogurt greek mixed berry low fat
yogurt greek mixed berry nonfat	yogurt greek mixed berry nonfat
yogurt greek banana whole milk	yogurt greek banana whole milk
yogurt greek banana low fat	yogurt greek banana low fat
yogurt greek banana nonfat	yogurt greek banana nonfat
yogurt greek coconut whole milk	yogurt greek coconut whole milk
yogurt greek coconut low fat	yogurt greek coconut low fat
yogurt greek coconut nonfat	yogurt greek coconut nonfat
yogurt greek key lime whole milk	yogurt greek key lime whole milk
yogurt greek key lime low fat	yogurt greek key lime low fat
yogurt greek key lime nonfat	yogurt greek key lime nonfat
yogurt greek lemon whole milk	yogurt greek lemon whole milk
yogurt greek lemon low fat	yogurt greek lemon low fat
yogurt greek lemon nonfat	yogurt greek lemon nonfat
yogurt greek orange whole milk	yogurt greek orange whole milk
yogurt greek orange low fat	yogurt greek orange low fat
yogurt greek orange nonfat	yogurt greek orange nonfat
yogurt greek pomegranate whole milk	yogurt greek pomegranate whole milk
yogurt greek pomegranate low fat	yogurt greek pomegranate low fat
yogurt greek pomegranate nonfat	yogurt greek pomegranate nonfat
yogurt greek mango whole milk	yogurt greek mango whole milk
yogurt greek mango low fat	yogurt greek mango low fat
yogurt greek mango nonfat	yogurt greek mango nonfat
yogurt greek tropical whole milk	yogurt greek tropical whole milk
yogurt greek tropical low fat	yogurt greek tropical low fat
yogurt greek tropical nonfat	yogurt greek tropical nonfat
yogurt greek fig whole milk	yogurt greek fig whole milk
yogurt greek fig low fat	yogurt greek fig low fat
yogurt greek fig nonfat	yogurt greek fig nonfat
yogurt greek apricot whole milk	yogurt greek apricot whole milk
yogurt greek apricot low fat	yogurt greek apricot low fat
yogurt greek apricot nonfat	yogurt greek apricot nonfat
yogurt greek apple whole milk	yogurt greek apple whole milk
yogurt greek apple low fat	yogurt greek apple low fat
yogurt greek apple nonfat	yogurt greek apple nonfat
yogurt greek pineapple whole milk	yogurt greek pineapple whole milk
yogurt greek pineapple low fat	yogurt greek pineapple low fat
yogurt greek pineapple nonfat	yogurt greek pineapple nonfat
yogurt greek blackberry whole milk	yogurt greek blackberry whole milk
yogurt greek blackberry low fat	yogurt greek blackberry low fat
yogurt greek blackberry nonfat	yogurt greek blackberry nonfat
yogurt greek elderberry whole milk	yogurt greek elderberry whole milk
yogurt greek elderberry low fat	yogurt greek elderberry low fat
yogurt greek elderberry nonfat	yogurt greek elderberry nonfat
yogurt greek cranberry whole milk	yogurt greek cranberry whole milk
yogurt greek cranberry low fat	yogurt greek cranberry low fat
yogurt greek cranberry nonfat	yogurt greek cranberry nonfat
yogurt greek grape whole milk	yogurt greek grape whole milk
yogurt greek grape low fat	yogurt greek grape low fat
yogurt greek grape nonfat	yogurt greek grape nonfat
yogurt greek kiwi whole milk	yogurt greek kiwi whole milk
yogurt greek kiwi low fat	yogurt greek kiwi low fat
yogurt greek kiwi nonfat	yogurt greek kiwi nonfat
yogurt greek passion fruit whole milk	yogurt greek passion fruit whole milk
yogurt greek passion fruit low fat	yogurt greek passion fruit low fat
yogurt greek passion fruit nonfat	yogurt greek passion fruit nonfat
yogurt greek guava whole milk	yogurt greek guava whole milk
yogurt greek guava low fat	yogurt greek guava low fat
yogurt greek guava nonfat	yogurt greek guava nonfat
yogurt greek papaya whole milk	yogurt greek papaya whole milk
yogurt greek papaya low fat	yogurt greek papaya low fat
yogurt greek papaya nonfat	yogurt greek papaya nonfat
yogurt greek dragon fruit whole milk	yogurt greek dragon fruit whole milk
yogurt greek dragon fruit low fat	yogurt greek dragon fruit low fat
yogurt greek dragon fruit nonfat	yogurt greek dragon fruit nonfat
yogurt greek star fruit whole milk	yogurt greek star fruit whole milk
yogurt greek star fruit low fat	yogurt greek star fruit low fat
yogurt greek star fruit nonfat	yogurt greek star fruit nonfat
yogurt greek lychee whole milk	yogurt greek lychee whole milk
yogurt greek lychee low fat	yogurt greek lychee low fat
yogurt greek lychee nonfat	yogurt greek lychee nonfat
yogurt greek rambutan whole milk	yogurt greek rambutan whole milk
yogurt greek rambutan low fat	yogurt greek rambutan low fat
yogurt greek rambutan nonfat	yogurt greek rambutan nonfat
yogurt greek durian whole milk	yogurt greek durian whole milk
yogurt greek durian low fat	yogurt greek durian low fat
yogurt greek durian nonfat	yogurt greek durian nonfat
yogurt greek jackfruit whole milk	yogurt greek jackfruit whole milk
yogurt greek jackfruit low fat	yogurt greek jackfruit low fat
yogurt greek jackfruit nonfat	yogurt greek jackfruit nonfat
yogurt greek breadfruit whole milk	yogurt greek breadfruit whole milk
yogurt greek breadfruit low fat	yogurt greek breadfruit low fat
yogurt greek breadfruit nonfat	yogurt greek breadfruit nonfat
yogurt greek plantain whole milk	yogurt greek plantain whole milk
yogurt greek plantain low fat	yogurt greek plantain low fat
yogurt greek plantain nonfat	yogurt greek plantain nonfat
yogurt greek custard apple whole milk	yogurt greek custard apple whole milk
yogurt greek custard apple low fat	yogurt greek custard apple low fat
yogurt greek custard apple nonfat	yogurt greek custard apple nonfat
yogurt greek soursop whole milk	yogurt greek soursop whole milk
yogurt greek soursop low fat	yogurt greek soursop low fat
yogurt greek soursop nonfat	yogurt greek soursop nonfat
yogurt greek cherimoya whole milk	yogurt greek cherimoya whole milk
yogurt greek cherimoya low fat	yogurt greek cherimoya low fat
yogurt greek cherimoya nonfat	yogurt greek cherimoya nonfat
yogurt greek atemoya whole milk	yogurt greek atemoya whole milk
yogurt greek atemoya low fat	yogurt greek atemoya low fat
yogurt greek atemoya nonfat	yogurt greek atemoya nonfat
yogurt greek sugar apple whole milk	yogurt greek sugar apple whole milk
yogurt greek sugar apple low fat	yogurt greek sugar apple low fat
yogurt greek sugar apple nonfat	yogurt greek sugar apple nonfat
yogurt greek sweetsop whole milk	yogurt greek sweetsop whole milk
yogurt greek sweetsop low fat	yogurt greek sweetsop low fat
yogurt greek sweetsop nonfat	yogurt greek sweetsop nonfat
soup beef vegetables canned ready serve	soup beef vegetables canned ready serve
restaurant chinese lemon chicken	restaurant chinese lemon chicken
mixed vegetable fruit juice drink with added nutrients	mixed vegetable fruit juice drink with added nutrients
cocoa mix no sugar added powder	cocoa mix no sugar added powder
snacks potato chips plain salted	snacks potato chips plain salted