crustaceans shrimp mixed species raw may contain additives retain moisture	crustaceans shrimp mixed species raw
fish tuna light canned water drained solids	fish tuna light canned water drained solids
pickle relish sweet	pickle relish sweet
peas green frozen cooked boiled drained without salt	peas green frozen cooked boiled drained without salt
carrots frozen cooked boiled drained without salt	carrots frozen cooked boiled drained without salt
broccoli frozen chopped cooked boiled drained without salt	broccoli frozen chopped cooked boiled drained without salt
corn sweet yellow frozen kernels cut off cob cooked boiled drained without salt	corn sweet yellow frozen kernels cut off cob cooked boiled drained without salt
beans green frozen cooked boiled drained without salt	beans green frozen cooked boiled drained without salt
cauliflower frozen cooked boiled drained without salt	cauliflower frozen cooked boiled drained without salt
spinach frozen chopped or leaf cooked boiled drained without salt	spinach frozen chopped or leaf cooked boiled drained without salt
squash summer crookneck and straightneck frozen cooked boiled drained without salt	squash summer crookneck and straightneck frozen cooked boiled drained without salt
asparagus frozen cooked boiled drained without salt	asparagus frozen cooked boiled drained without salt
brussels sprouts frozen cooked boiled drained without salt	brussels sprouts frozen cooked boiled drained without salt
lima beans immature seeds frozen baby cooked boiled drained without salt	lima beans immature seeds frozen baby cooked boiled drained without salt
okra frozen cooked boiled drained without salt	okra frozen cooked boiled drained without salt
mixed vegetables corn lima beans peas green beans carrots frozen cooked boiled drained without salt	mixed vegetables corn lima beans peas green beans carrots frozen cooked boiled drained without salt
potatoes mashed dehydrated prepared from granules without milk whole milk and butter added	potatoes mashed dehydrated prepared from granules without milk whole milk and butter added
potatoes mashed dehydrated prepared from granules with milk water and margarine added	potatoes mashed dehydrated prepared from granules with milk water and margarine added
potatoes mashed dehydrated prepared from flakes without milk whole milk and butter added	potatoes mashed dehydrated prepared from flakes without milk whole milk and butter added
potatoes mashed dehydrated prepared from flakes with milk water and margarine added	potatoes mashed dehydrated prepared from flakes with milk water and margarine added
potatoes hashed brown frozen plain prepared	potatoes hashed brown frozen plain prepared
potatoes hashed brown frozen with butter sauce prepared	potatoes hashed brown frozen with butter sauce prepared
potatoes french fried frozen as purchased	potatoes french fried frozen as purchased
potatoes french fried frozen prepared heated in oven without salt	potatoes french fried frozen prepared heated in oven without salt
potatoes french fried frozen prepared heated in oven with salt	potatoes french fried frozen prepared heated in oven with salt
potatoes french fried frozen shoestring cuts salt added in processing frozen as purchased	potatoes french fried frozen shoestring cuts salt added in processing frozen as purchased
potatoes french fried frozen shoestring cuts prepared heated in oven without salt	potatoes french fried frozen shoestring cuts prepared heated in oven without salt
potatoes french fried frozen shoestring cuts prepared heated in oven with salt	potatoes french fried frozen shoestring cuts prepared heated in oven with salt
potatoes french fried frozen cottage cuts salt added in processing frozen as purchased	potatoes french fried frozen cottage cuts salt added in processing frozen as purchased
potatoes french fried frozen cottage cuts prepared heated in oven without salt	potatoes french fried frozen cottage cuts prepared heated in oven without salt
potatoes french fried frozen cottage cuts prepared heated in oven with salt	potatoes french fried frozen cottage cuts prepared heated in oven with salt
potatoes french fried frozen extruded prepared heated in oven without salt	potatoes french fried frozen extruded prepared heated in oven without salt
potatoes french fried frozen extruded prepared heated in oven with salt	potatoes french fried frozen extruded prepared heated in oven with salt
sweet potato frozen cooked baked without salt	sweet potato frozen cooked baked without salt
onion rings breaded par fried frozen prepared heated in oven	onion rings breaded par fried frozen prepared heated in oven
vegetables mixed frozen cooked boiled drained without salt	vegetables mixed frozen cooked boiled drained without salt
corn sweet white frozen kernels cut off cob cooked boiled drained without salt	corn sweet white frozen kernels cut off cob cooked boiled drained without salt
corn sweet white canned whole kernel regular pack solids and liquids	corn sweet white canned whole kernel regular pack solids and liquids
corn sweet white canned whole kernel regular pack drained solids	corn sweet white canned whole kernel regular pack drained solids
corn sweet white canned whole kernel no salt added solids and liquids	corn sweet white canned whole kernel no salt added solids and liquids
corn sweet white canned whole kernel no salt added drained solids	corn sweet white canned whole kernel no salt added drained solids
corn sweet white canned cream style regular pack	corn sweet white canned cream style regular pack
corn sweet white canned cream style no salt added	corn sweet white canned cream style no salt added
corn sweet yellow canned whole kernel regular pack solids and liquids	corn sweet yellow canned whole kernel regular pack solids and liquids
corn sweet yellow canned whole kernel regular pack drained solids	corn sweet yellow canned whole kernel regular pack drained solids
corn sweet yellow canned whole kernel vacuum pack	corn sweet yellow canned whole kernel vacuum pack
corn sweet yellow canned whole kernel no salt added solids and liquids	corn sweet yellow canned whole kernel no salt added solids and liquids
corn sweet yellow canned whole kernel no salt added drained solids	corn sweet yellow canned whole kernel no salt added drained solids
corn sweet yellow canned cream style regular pack	corn sweet yellow canned cream style regular pack
corn sweet yellow canned cream style no salt added	corn sweet yellow canned cream style no salt added
peas green canned regular pack solids and liquids	peas green canned regular pack solids and liquids
peas green canned regular pack drained solids	peas green canned regular pack drained solids
peas green canned no salt added solids and liquids	peas green canned no salt added solids and liquids
peas green canned no salt added drained solids	peas green canned no salt added drained solids
peas green canned seasoned solids and liquids	peas green canned seasoned solids and liquids
carrots canned regular pack solids and liquids	carrots canned regular pack solids and liquids
carrots canned regular pack drained solids	carrots canned regular pack drained solids
carrots canned no salt added solids and liquids	carrots canned no salt added solids and liquids
carrots canned no salt added drained solids	carrots canned no salt added drained solids
green beans canned regular pack solids and liquids	green beans canned regular pack solids and liquids
green beans canned regular pack drained solids	green beans canned regular pack drained solids
green beans canned no salt added solids and liquids	green beans canned no salt added solids and liquids
green beans canned no salt added drained solids	green beans canned no salt added drained solids
green beans canned seasoned solids and liquids	green beans canned seasoned solids and liquids
wax beans canned regular pack solids and liquids	wax beans canned regular pack solids and liquids
wax beans canned regular pack drained solids	wax beans canned regular pack drained solids
wax beans canned no salt added solids and liquids	wax beans canned no salt added solids and liquids
wax beans canned no salt added drained solids	wax beans canned no salt added drained solids
lima beans immature seeds canned regular pack solids and liquids	lima beans immature seeds canned regular pack solids and liquids
lima beans immature seeds canned regular pack drained solids	lima beans immature seeds canned regular pack drained solids
lima beans immature seeds canned no salt added solids and liquids	lima beans immature seeds canned no salt added solids and liquids
lima beans immature seeds canned no salt added drained solids	lima beans immature seeds canned no salt added drained solids
beets canned regular pack solids and liquids	beets canned regular pack solids and liquids
beets canned regular pack drained solids	beets canned regular pack drained solids
beets canned no salt added solids and liquids	beets canned no salt added solids and liquids
beets canned no salt added drained solids	beets canned no salt added drained solids
spinach canned regular pack solids and liquids	spinach canned regular pack solids and liquids
spinach canned regular pack drained solids	spinach canned regular pack drained solids
spinach canned no salt added solids and liquids	spinach canned no salt added solids and liquids
spinach canned no salt added drained solids	spinach canned no salt added drained solids
asparagus canned regular pack solids and liquids	asparagus canned regular pack solids and liquids
asparagus canned regular pack drained solids	asparagus canned regular pack drained solids
asparagus canned no salt added solids and liquids	asparagus canned no salt added solids and liquids
asparagus canned no salt added drained solids	asparagus canned no salt added drained solids
mushrooms canned drained solids	mushrooms canned drained solids
mushrooms canned solids and liquids	mushrooms canned solids and liquids
sauerkraut canned solids and liquids	sauerkraut canned solids and liquids
tomatoes red ripe canned whole regular pack	tomatoes red ripe canned whole regular pack
tomatoes red ripe canned whole no salt added	tomatoes red ripe canned whole no salt added
tomatoes red ripe canned stewed	tomatoes red ripe canned stewed
tomatoes red ripe canned crushed	tomatoes red ripe canned crushed
tomatoes red ripe canned diced	tomatoes red ripe canned diced
tomato puree canned no salt added	tomato puree canned no salt added
tomato puree canned with salt added	tomato puree canned with salt added
tomato paste canned no salt added	tomato paste canned no salt added
tomato paste canned with salt added	tomato paste canned with salt added
vegetable juice cocktail canned	vegetable juice cocktail canned
vegetable juice cocktail canned low sodium	vegetable juice cocktail canned low sodium
tomato juice canned with salt added	tomato juice canned with salt added
tomato juice canned no salt added	tomato juice canned no salt added
tomato and vegetable juice low sodium	tomato and vegetable juice low sodium
beans snap yellow canned regular pack solids and liquids	beans snap yellow canned regular pack solids and liquids
beans snap yellow canned regular pack drained solids	beans snap yellow canned regular pack drained solids
beans snap yellow canned no salt added solids and liquids	beans snap yellow canned no salt added solids and liquids
beans snap yellow canned no salt added drained solids	beans snap yellow canned no salt added drained solids
mixed vegetables peas and carrots canned regular pack solids and liquids	mixed vegetables peas and carrots canned regular pack solids and liquids
mixed vegetables peas and carrots canned regular pack drained solids	mixed vegetables peas and carrots canned regular pack drained solids
mixed vegetables peas and carrots canned no salt added solids and liquids	mixed vegetables peas and carrots canned no salt added solids and liquids
mixed vegetables peas and carrots canned no salt added drained solids	mixed vegetables peas and carrots canned no salt added drained solids
mixed vegetables corn lima beans peas green beans and carrots canned regular pack solids and liquids	mixed vegetables corn lima beans peas green beans and carrots canned regular pack solids and liquids
mixed vegetables corn lima beans peas green beans and carrots canned regular pack drained solids	mixed vegetables corn lima beans peas green beans and carrots canned regular pack drained solids
mixed vegetables corn lima beans peas green beans and carrots canned no salt added solids and liquids	mixed vegetables corn lima beans peas green beans and carrots canned no salt added solids and liquids
mixed vegetables corn lima beans peas green beans and carrots canned no salt added drained solids	mixed vegetables corn lima beans peas green beans and carrots canned no salt added drained solids
succotash corn and lima beans canned with whole kernel corn solids and liquids	succotash corn and lima beans canned with whole kernel corn solids and liquids
succotash corn and lima beans canned with whole kernel corn drained solids	succotash corn and lima beans canned with whole kernel corn drained solids
succotash corn and lima beans canned with cream style corn solids and liquids	succotash corn and lima beans canned with cream style corn solids and liquids
potatoes canned whole solids and liquids	potatoes canned whole solids and liquids
potatoes canned whole drained solids	potatoes canned whole drained solids
sweet potato canned mashed	sweet potato canned mashed
sweet potato canned syrup pack solids and liquids	sweet potato canned syrup pack solids and liquids
sweet potato canned syrup pack drained solids	sweet potato canned syrup pack drained solids
sweet potato canned vacuum pack	sweet potato canned vacuum pack
sweet potato canned vacuum pack mashed	sweet potato canned vacuum pack mashed
pumpkin canned without salt	pumpkin canned without salt
pumpkin canned with salt	pumpkin canned with salt
artichokes globe or french frozen cooked boiled drained without salt	artichokes globe or french frozen cooked boiled drained without salt
artichokes globe or french canned drained solids	artichokes globe or french canned drained solids
hearts of palm canned	hearts of palm canned
pickles cucumber dill low sodium	pickles cucumber dill low sodium
pickles cucumber sweet low sodium includes bread and butter pickles	pickles cucumber sweet low sodium includes bread and butter pickles
relish pickle corn	relish pickle corn
pickled vegetables mixed	pickled vegetables mixed
beans kidney red mature seeds canned solids and liquids	beans kidney red mature seeds canned solids and liquids
beans kidney red mature seeds canned drained solids	beans kidney red mature seeds canned drained solids
beans kidney red mature seeds canned solids and liquids low sodium	beans kidney red mature seeds canned solids and liquids low sodium
beans kidney red mature seeds canned drained solids low sodium	beans kidney red mature seeds canned drained solids low sodium
beans black mature seeds canned solids and liquids	beans black mature seeds canned solids and liquids
beans black mature seeds canned drained solids	beans black mature seeds canned drained solids
beans black mature seeds canned solids and liquids low sodium	beans black mature seeds canned solids and liquids low sodium
beans black mature seeds canned drained solids low sodium	beans black mature seeds canned drained solids low sodium
beans navy mature seeds canned solids and liquids	beans navy mature seeds canned solids and liquids
beans navy mature seeds canned drained solids	beans navy mature seeds canned drained solids
beans pinto mature seeds canned solids and liquids	beans pinto mature seeds canned solids and liquids
beans pinto mature seeds canned drained solids	beans pinto mature seeds canned drained solids
beans pinto mature seeds canned solids and liquids low sodium	beans pinto mature seeds canned solids and liquids low sodium
beans pinto mature seeds canned drained solids low sodium	beans pinto mature seeds canned drained solids low sodium
beans white mature seeds canned solids and liquids	beans white mature seeds canned solids and liquids
beans white mature seeds canned drained solids	beans white mature seeds canned drained solids
beans great northern mature seeds canned solids and liquids	beans great northern mature seeds canned solids and liquids
beans great northern mature seeds canned drained solids	beans great northern mature seeds canned drained solids
beans great northern mature seeds canned solids and liquids low sodium	beans great northern mature seeds canned solids and liquids low sodium
beans great northern mature seeds canned drained solids low sodium	beans great northern mature seeds canned drained solids low sodium
lima beans large mature seeds canned solids and liquids	lima beans large mature seeds canned solids and liquids
lima beans large mature seeds canned drained solids	lima beans large mature seeds canned drained solids
chickpeas garbanzo beans bengal gram mature seeds canned solids and liquids	chickpeas garbanzo beans bengal gram mature seeds canned solids and liquids
chickpeas garbanzo beans bengal gram mature seeds canned drained solids	chickpeas garbanzo beans bengal gram mature seeds canned drained solids
chickpeas garbanzo beans bengal gram mature seeds canned solids and liquids low sodium	chickpeas garbanzo beans bengal gram mature seeds canned solids and liquids low sodium
chickpeas garbanzo beans bengal gram mature seeds canned drained solids low sodium	chickpeas garbanzo beans bengal gram mature seeds canned drained solids low sodium
cowpeas black eyed peas mature seeds canned plain solids and liquids	cowpeas black eyed peas mature seeds canned plain solids and liquids
cowpeas black eyed peas mature seeds canned plain drained solids	cowpeas black eyed peas mature seeds canned plain drained solids
lentils mature seeds canned	lentils mature seeds canned
split peas yellow mature seeds canned	split peas yellow mature seeds canned
refried beans canned traditional style fat added	refried beans canned traditional style fat added
refried beans canned fat free	refried beans canned fat free
refried beans canned vegetarian	refried beans canned vegetarian
chili with beans canned	chili with beans canned
chili no beans canned	chili no beans canned
soup chicken noodle canned condensed	soup chicken noodle canned condensed
soup chicken noodle canned prepared with equal volume water	soup chicken noodle canned prepared with equal volume water
soup chicken rice canned condensed	soup chicken rice canned condensed
soup chicken rice canned prepared with equal volume water	soup chicken rice canned prepared with equal volume water
soup chicken vegetable canned condensed	soup chicken vegetable canned condensed
soup chicken vegetable canned prepared with equal volume water	soup chicken vegetable canned prepared with equal volume water
soup chicken with dumplings canned condensed	soup chicken with dumplings canned condensed
soup chicken with dumplings canned prepared with equal volume water	soup chicken with dumplings canned prepared with equal volume water
soup cream of chicken canned condensed	soup cream of chicken canned condensed
soup cream of chicken canned prepared with equal volume water	soup cream of chicken canned prepared with equal volume water
soup cream of chicken canned prepared with equal volume whole milk	soup cream of chicken canned prepared with equal volume whole milk
soup cream of celery canned condensed	soup cream of celery canned condensed
soup cream of celery canned prepared with equal volume water	soup cream of celery canned prepared with equal volume water
soup cream of celery canned prepared with equal volume whole milk	soup cream of celery canned prepared with equal volume whole milk
soup cream of mushroom canned condensed	soup cream of mushroom canned condensed
soup cream of mushroom canned prepared with equal volume water	soup cream of mushroom canned prepared with equal volume water
soup cream of mushroom canned prepared with equal volume whole milk	soup cream of mushroom canned prepared with equal volume whole milk
soup cream of potato canned condensed	soup cream of potato canned condensed
soup cream of potato canned prepared with equal volume water	soup cream of potato canned prepared with equal volume water
soup cream of potato canned prepared with equal volume whole milk	soup cream of potato canned prepared with equal volume whole milk
soup tomato canned condensed	soup tomato canned condensed
soup tomato canned prepared with equal volume water	soup tomato canned prepared with equal volume water
soup tomato canned prepared with equal volume whole milk	soup tomato canned prepared with equal volume whole milk
soup tomato rice canned condensed	soup tomato rice canned condensed
soup tomato rice canned prepared with equal volume water	soup tomato rice canned prepared with equal volume water
soup vegetable beef canned condensed	soup vegetable beef canned condensed
soup vegetable beef canned prepared with equal volume water	soup vegetable beef canned prepared with equal volume water
soup vegetarian vegetable canned condensed	soup vegetarian vegetable canned condensed
soup vegetarian vegetable canned prepared with equal volume water	soup vegetarian vegetable canned prepared with equal volume water
soup split pea with ham canned condensed	soup split pea with ham canned condensed
soup split pea with ham canned prepared with equal volume water	soup split pea with ham canned prepared with equal volume water
soup bean with pork canned condensed	soup bean with pork canned condensed
soup bean with pork canned prepared with equal volume water	soup bean with pork canned prepared with equal volume water
soup beef broth or bouillon powder dry	soup beef broth or bouillon powder dry
soup beef broth or bouillon powder prepared with water	soup beef broth or bouillon powder prepared with water
soup chicken broth or bouillon powder dry	soup chicken broth or bouillon powder dry
soup chicken broth or bouillon powder prepared with water	soup chicken broth or bouillon powder prepared with water
soup onion dry mix	soup onion dry mix
soup onion dry mix prepared with water	soup onion dry mix prepared with water
soup beef noodle dry mix	soup beef noodle dry mix
soup beef noodle dry mix prepared with water	soup beef noodle dry mix prepared with water
soup chicken noodle dry mix	soup chicken noodle dry mix
soup chicken noodle dry mix prepared with water	soup chicken noodle dry mix prepared with water
soup vegetable beef dry mix	soup vegetable beef dry mix
soup vegetable beef dry mix prepared with water	soup vegetable beef dry mix prepared with water