rice wheat cereal bar	rice wheat cereal bar
ravioli cheese with tomato sauce frozen not prepared includes regular light entrees	ravioli cheese with tomato sauce frozen not prepared includes regular light entrees
candies mars snackfood us m&m's peanut chocolate candies	candies mars snackfood us m&m's peanut chocolate candies
fast taco with chicken lettuce cheese soft	fast taco with chicken lettuce cheese soft
cocoa mix powder	cocoa mix powder
fish tuna yellowfin fresh raw	fish tuna yellowfin fresh raw
ice cream chocolate	ice cream chocolate
ice cream vanilla	ice cream vanilla
ice cream strawberry	ice cream strawberry
ice cream neapolitan	ice cream neapolitan
ice cream cookies and cream	ice cream cookies and cream
ice cream chocolate chip	ice cream chocolate chip
ice cream mint chocolate chip	ice cream mint chocolate chip
ice cream rocky road	ice cream rocky road
ice cream butter pecan	ice cream butter pecan
ice cream coffee	ice cream coffee
ice cream coconut	ice cream coconut
ice cream banana	ice cream banana
ice cream cherry	ice cream cherry
ice cream pistachio	ice cream pistachio
ice cream rum raisin	ice cream rum raisin
ice cream sherbet orange	ice cream sherbet orange
ice cream sherbet lime	ice cream sherbet lime
ice cream sherbet raspberry	ice cream sherbet raspberry
ice cream sherbet rainbow	ice cream sherbet rainbow
ice cream sandwich	ice cream sandwich
ice cream bar stick chocolate covered	ice cream bar stick chocolate covered
ice cream bar stick vanilla covered	ice cream bar stick vanilla covered
ice cream cone or cup chocolate	ice cream cone or cup chocolate
ice cream cone or cup vanilla	ice cream cone or cup vanilla
ice cream cone or cup strawberry	ice cream cone or cup strawberry
ice cream cone sugar rolled	ice cream cone sugar rolled
ice cream cone cake	ice cream cone cake
ice cream cone waffle	ice cream cone waffle
frozen yogurt chocolate	frozen yogurt chocolate
frozen yogurt vanilla	frozen yogurt vanilla
frozen yogurt strawberry	frozen yogurt strawberry
frozen yogurt fat free	frozen yogurt fat free
frozen yogurt soft serve chocolate	frozen yogurt soft serve chocolate
frozen yogurt soft serve vanilla	frozen yogurt soft serve vanilla
frozen yogurt soft serve strawberry	frozen yogurt soft serve strawberry
frozen yogurt soft serve fat free	frozen yogurt soft serve fat free
sorbet fruit	sorbet fruit
sorbet lemon	sorbet lemon
sorbet orange	sorbet orange
sorbet strawberry	sorbet strawberry
sorbet raspberry	sorbet raspberry
sorbet mango	sorbet mango
sorbet lime	sorbet lime
popsicles fruit	popsicles fruit
popsicles orange	popsicles orange
popsicles grape	popsicles grape
popsicles cherry	popsicles cherry
popsicles lime	popsicles lime
popsicles coconut	popsicles coconut
popsicles sugar free	popsicles sugar free
gelatin desserts prepared from powder	gelatin desserts prepared from powder
gelatin desserts prepared from powder sugar free	gelatin desserts prepared from powder sugar free
gelatin desserts prepared from dry mix	gelatin desserts prepared from dry mix
gelatin desserts prepared from dry mix sugar free	gelatin desserts prepared from dry mix sugar free
gelatin desserts prepared with fruit	gelatin desserts prepared with fruit
gelatin desserts prepared with fruit sugar free	gelatin desserts prepared with fruit sugar free
pudding chocolate prepared from powder	pudding chocolate prepared from powder
pudding vanilla prepared from powder	pudding vanilla prepared from powder
pudding butterscotch prepared from powder	pudding butterscotch prepared from powder
pudding banana prepared from powder	pudding banana prepared from powder
pudding coconut prepared from powder	pudding coconut prepared from powder
pudding lemon prepared from powder	pudding lemon prepared from powder
pudding chocolate prepared from dry mix	pudding chocolate prepared from dry mix
pudding vanilla prepared from dry mix	pudding vanilla prepared from dry mix
pudding butterscotch prepared from dry mix	pudding butterscotch prepared from dry mix
pudding banana prepared from dry mix	pudding banana prepared from dry mix
pudding coconut prepared from dry mix	pudding coconut prepared from dry mix
pudding lemon prepared from dry mix	pudding lemon prepared from dry mix
pudding chocolate sugar free prepared from powder	pudding chocolate sugar free prepared from powder
pudding vanilla sugar free prepared from powder	pudding vanilla sugar free prepared from powder
pudding butterscotch sugar free prepared from powder	pudding butterscotch sugar free prepared from powder
pudding banana sugar free prepared from powder	pudding banana sugar free prepared from powder
pudding coconut sugar free prepared from powder	pudding coconut sugar free prepared from powder
pudding lemon sugar free prepared from powder	pudding lemon sugar free prepared from powder
pudding chocolate sugar free prepared from dry mix	pudding chocolate sugar free prepared from dry mix
pudding vanilla sugar free prepared from dry mix	pudding vanilla sugar free prepared from dry mix
pudding butterscotch sugar free prepared from dry mix	pudding butterscotch sugar free prepared from dry mix
pudding banana sugar free prepared from dry mix	pudding banana sugar free prepared from dry mix
pudding coconut sugar free prepared from dry mix	pudding coconut sugar free prepared from dry mix
pudding lemon sugar free prepared from dry mix	pudding lemon sugar free prepared from dry mix
pudding rice	pudding rice
pudding rice with raisins	pudding rice with raisins
pudding bread	pudding bread
pudding bread with raisins	pudding bread with raisins
pudding tapioca	pudding tapioca
pudding tapioca with fruit	pudding tapioca with fruit
custard flan	custard flan
custard egg	custard egg
custard baked	custard baked
custard frozen	custard frozen
mousse chocolate	mousse chocolate
mousse vanilla	mousse vanilla
mousse strawberry	mousse strawberry
mousse lemon	mousse lemon
mousse orange	mousse orange
mousse banana	mousse banana
tiramisu	tiramisu
cheesecake	cheesecake
cheesecake chocolate	cheesecake chocolate
cheesecake strawberry	cheesecake strawberry
cheesecake blueberry	cheesecake blueberry
cheesecake cherry	cheesecake cherry
cheesecake lemon	cheesecake lemon
cheesecake new york style	cheesecake new york style
pie apple	pie apple
pie cherry	pie cherry
pie blueberry	pie blueberry
pie strawberry	pie strawberry
pie peach	pie peach
pie pumpkin	pie pumpkin
pie sweet potato	pie sweet potato
pie pecan	pie pecan
pie lemon meringue	pie lemon meringue
pie chocolate cream	pie chocolate cream
pie coconut cream	pie coconut cream
pie banana cream	pie banana cream
pie key lime	pie key lime
pie rhubarb	pie rhubarb
pie mincemeat	pie mincemeat
pie custard	pie custard
pie chess	pie chess
pie buttermilk	pie buttermilk
pie fried apple	pie fried apple
pie fried cherry	pie fried cherry
pie crust	pie crust
pie crust frozen	pie crust frozen
pie crust graham cracker	pie crust graham cracker
pie crust chocolate	pie crust chocolate
pie crust vanilla wafer	pie crust vanilla wafer
tart fruit	tart fruit
tart lemon	tart lemon
tart chocolate	tart chocolate
tart custard	tart custard
pastry cream puff	pastry cream puff
pastry eclair	pastry eclair
pastry napoleon	pastry napoleon
pastry strudel apple	pastry strudel apple
pastry strudel cherry	pastry strudel cherry
pastry baklava	pastry baklava
pastry cannoli	pastry cannoli
pastry rugelach	pastry rugelach
pastry bear claw	pastry bear claw
pastry palmier	pastry palmier
turnover apple	turnover apple
turnover cherry	turnover cherry
turnover strawberry	turnover strawberry
turnover peach	turnover peach
turnover apricot	turnover apricot
cobbler fruit	cobbler fruit
cobbler apple	cobbler apple
cobbler peach	cobbler peach
cobbler berry	cobbler berry
cobbler cherry	cobbler cherry
crisp apple	crisp apple
crisp peach	crisp peach
crisp berry	crisp berry
crisp cherry	crisp cherry
crisp rhubarb	crisp rhubarb
crumble fruit	crumble fruit
crumble apple	crumble apple
crumble peach	crumble peach
crumble berry	crumble berry
crumble cherry	crumble cherry
betty fruit	betty fruit
betty apple	betty apple
betty peach	betty peach
betty berry	betty berry
betty cherry	betty cherry
parfait fruit	parfait fruit
parfait chocolate	parfait chocolate
parfait vanilla	parfait vanilla
parfait strawberry	parfait strawberry
parfait peach	parfait peach
trifle fruit	trifle fruit
trifle chocolate	trifle chocolate
trifle vanilla	trifle vanilla
trifle strawberry	trifle strawberry
trifle peach	trifle peach
sundae hot fudge	sundae hot fudge
sundae caramel	sundae caramel
sundae strawberry	sundae strawberry
sundae butterscotch	sundae butterscotch
sundae chocolate	sundae chocolate
banana split	banana split
milkshake chocolate	milkshake chocolate
milkshake vanilla	milkshake vanilla
milkshake strawberry	milkshake strawberry
milkshake banana	milkshake banana
milkshake malt	milkshake malt
float root beer	float root beer
float coke	float coke
float orange	float orange
float grape	float grape
float cherry	float cherry
smoothie fruit	smoothie fruit
smoothie strawberry	smoothie strawberry
smoothie banana	smoothie banana
smoothie mango	smoothie mango
smoothie peach	smoothie peach
smoothie mixed berry	smoothie mixed berry
smoothie tropical	smoothie tropical
smoothie green	smoothie green
smoothie protein	smoothie protein
smoothie yogurt	smoothie yogurt
candies chocolate dark	candies chocolate dark
candies chocolate milk	candies chocolate milk
candies chocolate white	candies chocolate white
candies chocolate semi sweet	candies chocolate semi sweet
candies chocolate baking	candies chocolate baking
candies chocolate chips	candies chocolate chips
candies chocolate covered nuts	candies chocolate covered nuts
candies chocolate covered raisins	candies chocolate covered raisins
candies chocolate covered pretzels	candies chocolate covered pretzels
candies chocolate covered strawberries	candies chocolate covered strawberries
candies chocolate truffles	candies chocolate truffles
candies chocolate fudge	candies chocolate fudge
candies chocolate caramels	candies chocolate caramels
candies chocolate nougat	candies chocolate nougat
candies chocolate toffee	candies chocolate toffee
candies chocolate brittle	candies chocolate brittle
candies chocolate bark	candies chocolate bark
candies chocolate buttons	candies chocolate buttons
candies chocolate coins	candies chocolate coins
candies chocolate eggs	candies chocolate eggs
soup cream of chicken canned condensed	soup cream of chicken canned condensed
puddings chocolate dry mix instant	puddings chocolate dry mix instant
pork fresh shoulder whole separable lean only cooked roasted	pork fresh shoulder whole separable lean only cooked roasted
candies white chocolate	candies white chocolate
crackers melba toast plain	crackers melba toast plain