List_A_Item	Best_Match_from_List_B
"""butter, salted"""	unsalted butter
"""cheese, cheddar"""	sharp chedder cheese
"""cream, fluid, half and half"""	half and half
"""cream, sour, cultured"""	sour cream
"""milk, whole, 3.25% milkfat, with added vitamin d"""	whole milk
"""milk, reduced fat, fluid, 2% milkfat, with added vitamin a and vitamin d"""	whole milk
"""egg, whole, raw, fresh"""	whole brown egg
"""egg, yolk, raw, fresh"""	brown egg yolk
"""chicken, broiler or fryers, breast, skinless, boneless, meat only, raw"""	chicken breast
"""soup, chicken broth, ready-to-serve"""	low sodium chicken broth
"""garlic, raw"""	garlic
"""mushrooms, white, raw"""	steamed whole white mushrooms
"""mushrooms, canned, drained solids"""	steamed whole white mushrooms
"""onions, raw"""	onion
"""peppers, sweet, green, raw"""	steamed whole green bell pepper w/o seed
"""tomatoes, red, ripe, raw, year round average"""	whole green house (large) tomato
"""tomatoes, red, ripe, canned, packed in tomato juice"""	muir's diced tomatoes
"""seaweed, wakame, raw"""	roasted seaweed
"""peppers, jalapeno, raw"""	jalapeno
"""beverages, coffee, brewed, prepared with tap water"""	brewed coffee
"""refried beans, canned, traditional style"""	refried beans
"""soy flour, defatted"""	soy flour
"""cocoa, dry powder, unsweetened"""	cocoa powder
"""sugars, granulated"""	table sugar
"""barley, pearled, raw"""	whole grain pearl barley
cornstarch	corn starch
"""rice, white, long-grain, regular, raw, enriched"""	enriched long white rice (mahatma)
"""wheat flour, white, all-purpose, enriched, bleached"""	all purpose flour
"""beef, top sirloin, steak, separable lean only, trimmed to 1/8"""" fat, choice, raw"""	beef round tip steak
"""celery, raw"""	steamed celery stalk
"""coriander (cilantro) leaves, raw"""	cilantro
"""cucumber, with peel, raw"""	whole english cucumber
"""tomato products, canned, paste, without salt added"""	hunt's tomato paste
"""beverages, carbonated, cola, regular"""	coca cola
"""rice, white, long-grain, regular, enriched, cooked"""	enriched long white rice (mahatma)
"""wheat bran, crude"""	wheat bran cereal
"""beef, ground, 90% lean meat / 10% fat, patty, cooked, broiled"""	ground pork
"""beef, ground, 85% lean meat / 15% fat, patty, cooked, broiled"""	ground pork
"""beef, ground, 80% lean meat / 20% fat, patty, cooked, broiled"""	ground pork
"""beef, ground, 75% lean meat / 25% fat, patty, cooked, broiled"""	ground pork
"""egg, white, raw, fresh"""	brown egg white
"""cheese product, pasteurized process, american, vitamin d fortified"""	american cheese
"""turkey, ground, cooked"""	ground turkey
"""cabbage, raw"""	purple cabbage
"""tomato products, canned, sauce"""	hunt's tomato sauce
"""beef, top sirloin, steak, separable lean and fat, trimmed to 0"""" fat, all grades, cooked, broiled"""	beef round tip steak
"""beef, top sirloin, steak, separable lean only, trimmed to 0"""" fat, all grades, cooked, broiled"""	beef round tip steak
"""beef, round, top round steak, boneless, separable lean only, trimmed to 0"""" fat, all grades, cooked, grilled"""	beef round tip steak
"""beef, round, top round steak, boneless, separable lean and fat, trimmed to 0"""" fat, all grades, cooked, grilled"""	beef round tip steak
"""beverages, carbonated, sprite, lemon-lime, without caffeine"""	sprite
"""beverages, coffee, instant, decaffeinated, powder"""	brewed coffee
"""beans, black, mature seeds, cooked, boiled, without salt"""	canned black beans (s&w)
"""beans, pinto, mature seeds, cooked, boiled, without salt"""	canned low sodium pinto bean
"""sugars, brown"""	none
"""candies, chocolate, dark, nfs (45-59% cacao solids 90%; 60-69% cacao solids 5%; 70-85% cacao solids 5%)"""	chocolate
"""beef, short loin, top loin, steak, separable lean only, trimmed to 1/8"""" fat, all grades, cooked, broiled"""	beef round tip steak
"""cheese spread, pasteurized process, american"""	american cheese
"""lettuce, iceberg (includes crisphead types), raw"""	steamed iceberg lettuce
"""chicken, broiler, rotisserie, bbq, breast, meat only"""	chicken breast
"""orange juice, chilled, includes from concentrate"""	pulp free orange juice
"""mung beans, mature seeds, sprouted, raw"""	bean sprouts
"""onions, young green, tops only"""	green onion
"""nuts, almonds"""	roasted almonds
"""nuts, walnuts, english"""	walnuts
"""beverages, carbonated, cola, without caffeine"""	coca cola
"""beverages, coffee, brewed, prepared with tap water, decaffeinated"""	brewed coffee
"""beverages, tea, black, brewed, prepared with tap water"""	black tea
"""cornmeal, degermed, enriched, yellow"""	cornmeal
"""cheese, mozzarella, low moisture, part-skim"""	low moisture part skim mozarella cheese
"""cheese product, pasteurized process, american, reduced fat, fortified with vitamin d"""	american cheese
"""cheese, pasteurized process, american, without added vitamin d"""	american cheese
"""cheese spread, american or cheddar cheese base, reduced fat"""	american cheese
"""cheese, cheddar, reduced fat"""	sharp chedder cheese
"""cranberries, dried, sweetened"""	cranberry
"""orange juice, chilled, includes from concentrate, with added calcium and vitamin d"""	pulp free orange juice
"""orange juice, chilled, includes from concentrate, with added calcium"""	pulp free orange juice
"""spinach, canned, regular pack, drained solids"""	frozen chopped spinach (green giant)
"""beans, kidney, red, mature seeds, raw"""	canned kidney beans
"""beans, kidney, red, mature seeds, canned, solids and liquids"""	canned kidney beans
"""snacks, popcorn, air-popped"""	popcorn
"""cheese, cream, low fat"""	sour cream
"""sausage, pork, chorizo, link or ground, cooked, pan-fried"""	ground pork
"""cheese, cottage, creamed, large or small curd"""	cottage cheese
"""chicken, broilers or fryers, thigh, meat only, cooked, roasted"""	chicken breast
"""cabbage, red, raw"""	purple cabbage
"""potatoes, boiled, cooked without skin, flesh, without salt"""	steamed whole russet potato
"""nuts, pecans"""	pecan
"""beverages, coffee, instant, regular, powder"""	brewed coffee
honey	honey
"""wheat flour, whole-grain (includes foods for usda's food distribution program)"""	whole wheat flour
"""pineapple, canned, water pack, solids and liquids"""	gold (golden) pineapple
"""potatoes, baked, flesh, without salt"""	steamed whole russet potato
"""pickle relish, sweet"""	pickles
"""chicken, broiler, rotisserie, bbq, drumstick, meat only"""	chicken breast
"""parsley, fresh"""	parsley
"""sweet potato, cooked, baked in skin, flesh, without salt"""	steamed whole sweet potato
"""lima beans, immature seeds, frozen, fordhook, cooked, boiled, drained, without salt"""	lima beans
"""cauliflower, raw"""	steamed cauliflower florets and stalk
"""seeds, sunflower seed kernels, dry roasted, without salt"""	sunflower seeds
"""asparagus, raw"""	frozen whole baby asparagus
"""blueberries, raw"""	whole blueberry
"""peppers, sweet, green, cooked, boiled, drained, without salt"""	steamed whole green bell pepper w/o seed
"""nuts, cashew nuts, dry roasted, without salt added"""	cashew
"""beef, round, top round steak, separable lean and fat, trimmed to 1/8"""" fat, all grades, cooked, broiled"""	beef round tip steak
"""peanuts, all types, raw"""	peanuts
"""peanuts, all types, dry-roasted, with salt"""	peanuts
"""egg, whole, cooked, hard-boiled"""	whole brown egg
"""beef, ground, 85% lean meat / 15% fat, crumbles, cooked, pan-browned"""	ground pork
"""beef, ground, 80% lean meat / 20% fat, crumbles, cooked, pan-browned"""	ground pork
"""butter, whipped, with salt"""	unsalted butter
"""yogurt, plain, whole milk"""	yogurt
"""apple juice, canned or bottled, unsweetened, without added ascorbic acid"""	apple juice
"""apricots, raw"""	whole apricot
"""blackberries, raw"""	whole blackberry
"""grapes, red or green (european type, such as thompson seedless), raw"""	red seedless grape
"""peaches, yellow, raw"""	whole yellow peach (prima farms)
"""raspberries, raw"""	whole raspberry
"""strawberries, raw"""	whole strawberry
"""blueberries, frozen, unsweetened"""	frozen whole blueberry
"""pears, raw"""	whole bartlett pear flesh only
"""chickpeas (garbanzo beans, bengal gram), mature seeds, cooked, boiled, without salt"""	canned garbanzo beans
"""turkey, all classes, light meat, cooked, roasted"""	ground turkey
"""onions, cooked, boiled, drained, without salt"""	onion
"""squash, summer, all varieties, cooked, boiled, drained, without salt"""	steamed yellow neck squash
"""cheese, cottage, lowfat, 2% milkfat"""	cottage cheese
"""pineapple, raw, all varieties"""	gold (golden) pineapple
"""seaweed, laver, raw"""	roasted seaweed
"""beverages, coffee, brewed, espresso, restaurant-prepared"""	brewed coffee
"""soy sauce made from soy and wheat (shoyu), low sodium"""	soy sauce
"""syrups, maple"""	maple syrup
"""oat bran, raw"""	cooked oat bran
"""rice, white, glutinous, unenriched, cooked"""	enriched long white rice (mahatma)
"""cherries, sweet, raw"""	whole sweet cherry
"""grapefruit, raw, pink and red, all areas"""	deep red grapefruit
"""lime juice, raw"""	lime juice
"""melons, cantaloupe, raw"""	cantaloupe melon
"""beans, great northern, mature seeds, canned"""	great northern beans
"""butter, without salt"""	unsalted butter
"""broccoli, frozen, chopped, cooked, boiled, drained, without salt"""	frozen broccoli florets
"""carrots, frozen, cooked, boiled, drained, without salt"""	steamed whole carrots
"""squash, summer, crookneck and straightneck, raw"""	steamed yellow neck squash
"""squash, summer, zucchini, includes skin, raw"""	steamed green zuchini
"""cheese, cream"""	sour cream
"""bacon, turkey, microwaved"""	plant based bacon strip
"""cranberry sauce, canned, sweetened"""	cranberry
"""apple juice, canned or bottled, unsweetened, with added ascorbic acid"""	apple juice
"""beans, snap, green, frozen, cooked, boiled, drained without salt"""	steamed green beans
"""sugars, powdered"""	table sugar
"""plums, raw"""	whole red plum
"""peanuts, all types, dry-roasted, without salt"""	peanuts
"""turkey from whole, light meat, meat only, with added solution, cooked, roasted"""	ground turkey
"""tangerines, (mandarin oranges), canned, juice pack"""	pixie tangerine
"""spinach, raw"""	spinach leaves
"""beef, round, tip round, roast, separable lean only, trimmed to 0"""" fat, all grades, cooked, roasted"""	beef round tip steak
"""barley, pearled, cooked"""	whole grain pearl barley
"""butter oil, anhydrous"""	unsalted butter
"""salad dressing, mayonnaise, light"""	mayonnaise
"""snacks, popcorn, cheese-flavor"""	popcorn
"""peppers, sweet, red, raw"""	steamed whole red bell pepper w/o seed
"""mustard greens, raw"""	steamed curely mustard greens
"""beverages, almond milk, unsweetened, shelf stable"""	unsweetened almond milk
"""beverages, coconut milk, sweetened, fortified with calcium, vitamins a, b12, d2"""	coconut milk
"""crustaceans, shrimp, mixed species, cooked, moist heat (may have been previously frozen)"""	shrimp
soy sauce made from soy and wheat (shoyu)	soy sauce
"""tofu, soft, prepared with calcium sulfate and magnesium chloride (nigari)"""	soft silken tofu
"""beans, snap, green, raw"""	steamed green beans
"""mushrooms, white, cooked, boiled, drained, without salt"""	steamed whole white mushrooms
"""sweet potato, cooked, boiled, without skin"""	steamed whole sweet potato
"""orange juice, raw"""	pulp free orange juice
"""corn, sweet, yellow, frozen, kernels cut off cob, boiled, drained, without salt"""	frozen golden corn kernels (siganture select)
"""cowpeas, common (blackeyes, crowder, southern), mature seeds, cooked, boiled, without salt"""	black-eyed peas
"""turkey, whole, meat only, cooked, roasted"""	ground turkey
"""turkey, whole, meat only, with added solution, roasted"""	ground turkey
"""carrots, cooked, boiled, drained, without salt"""	steamed whole carrots
"""beverages, pepsico quaker, gatorade, g performance o 2, ready-to-drink."""	gatorade
"""cabbage, cooked, boiled, drained, without salt"""	purple cabbage
"""cauliflower, frozen, cooked, boiled, drained, without salt"""	steamed cauliflower florets and stalk
"""squash, summer, crookneck and straightneck, frozen, cooked, boiled, drained, without salt"""	steamed yellow neck squash
"""squash, summer, zucchini, includes skin, frozen, cooked, boiled, drained, without salt"""	steamed green zuchini
"""seeds, pumpkin and squash seed kernels, roasted, without salt"""	pumpkin seeds
"""nuts, almonds, dry roasted, without salt added"""	roasted almonds
"""nuts, brazilnuts, dried, unblanched"""	brazil nuts
"""nuts, coconut milk, raw (liquid expressed from grated meat and water)"""	coconut milk
"""nuts, pistachio nuts, dry roasted, without salt added"""	pistachio (fiddyment farm)
"""lentils, mature seeds, cooked, boiled, without salt"""	whole grain brown lentils
"""collards, raw"""	steamed collard greens leaves and stalk
"""peas, split, mature seeds, cooked, boiled, without salt"""	green split peas
"""beef, top sirloin, steak, separable lean only, trimmed to 1/8"""" fat, all grades, cooked, broiled"""	beef round tip steak
"""yogurt, plain, low fat"""	yogurt
"""tomato products, canned, puree, with salt added"""	hunt's tomato paste
"""beans, kidney, red, mature seeds, cooked, boiled, without salt"""	canned kidney beans
"""beef, loin, top loin steak, boneless, lip off, separable lean only, trimmed to 0"""" fat, all grades, raw"""	beef round tip steak
"""beef, loin, top loin steak, boneless, lip off, separable lean and fat, trimmed to 0"""" fat, all grades, raw"""	beef round tip steak
"""melons, honeydew, raw"""	honeydew melon
"""lettuce, red leaf, raw"""	romaine lettuce
"""okra, frozen, cooked, boiled, drained, without salt"""	frozen whole okra
"""beef, round, full cut, separable lean and fat, trimmed to 1/8"""" fat, choice, cooked, broiled"""	beef round tip steak
"""beef, ground, 75% lean meat / 25% fat, crumbles, cooked, pan-browned"""	ground pork
"""strawberries, frozen, unsweetened"""	whole strawberry
"""tangerines, (mandarin oranges), raw"""	pixie tangerine
"""snacks, banana chips"""	banana chips
"""turkey, dark meat, meat only, with added solution, cooked, roasted"""	ground turkey
"""spinach, frozen, chopped or leaf, cooked, boiled, drained, without salt"""	frozen chopped spinach (green giant)
"""crustaceans, shrimp, mixed species, raw (may contain additives to retain moisture)"""	shrimp
"""beef, round, top round steak, boneless, separable lean only, trimmed to 0"""" fat, all grades, raw"""	beef round tip steak
"""beans, black turtle, mature seeds, cooked, boiled, without salt"""	canned black beans (s&w)
"""cauliflower, cooked, boiled, drained, without salt"""	steamed cauliflower florets and stalk
"""peppers, sweet, red, cooked, boiled, drained, without salt"""	steamed whole red bell pepper w/o seed
"""nuts, almonds, blanched"""	roasted almonds
"""chickpeas (garbanzo beans, bengal gram), mature seeds, raw"""	canned garbanzo beans
"""applesauce, canned, sweetened, without salt"""	original apple sauce (tree top)
"""beef, round, top round roast, boneless, separable lean only, trimmed to 0"""" fat, all grades, raw"""	beef round tip steak
"""beef, round, top round roast, boneless, separable lean and fat, trimmed to 0"""" fat, all grades, raw"""	beef round tip steak
"""beef, round, eye of round roast, boneless, separable lean only, trimmed to 0"""" fat, all grades, raw"""	beef round tip steak
"""chicken, broilers or fryers, drumstick, meat only, cooked, braised"""	chicken breast
"""chicken, broilers or fryers, dark meat, thigh, meat only, cooked, braised"""	none
"""turkey, all classes, wing, meat and skin, cooked, roasted"""	ground turkey
"""turkey, wing, from whole bird, meat only, with added solution, roasted"""	ground turkey
"""beef, cured, breakfast strips, cooked"""	plant based bacon strip
"""nuts, macadamia nuts, dry roasted, with salt added"""	macadamia (sunfood superfood)
"""grapefruit, sections, canned, water pack, solids and liquids"""	deep red grapefruit
"""brussels sprouts, raw"""	steamed whole brussel sprouts
"""cocoa, dry powder, unsweetened, processed with alkali"""	cocoa powder
"""beverages, coffee, brewed, espresso, restaurant-prepared, decaffeinated"""	brewed coffee
"""crustaceans, shrimp, mixed species, canned"""	shrimp
"""alfalfa seeds, sprouted, raw"""	bean sprouts
"""turkey, whole, meat only, raw"""	ground turkey
"""chives, raw"""	chives
"""beef, ground, 95% lean meat / 5% fat, raw"""	ground pork
"""beef, ground, 90% lean meat / 10% fat, raw"""	ground pork
"""beef, ground, 80% lean meat / 20% fat, raw"""	ground pork
"""beef, ground, 75% lean meat / 25% fat, raw"""	ground pork
"""beets, raw"""	"""peeled, steamed beetroot"""
"""carrot juice, canned"""	carrot juice
"""frankfurter, turkey"""	plant based hot dog
"""nectarines, raw"""	whole yellow nectarine
"""watermelon, raw"""	seedless watermelon
"""okra, cooked, boiled, drained, without salt"""	frozen whole okra
"""plums, dried (prunes), stewed, without added sugar"""	unsweetened pitted prunes
"""turkey, thigh, from whole bird, meat only, with added solution, roasted"""	ground turkey
"""turkey, thigh, from whole bird, meat only, roasted"""	ground turkey
"""milk, chocolate, fat free, with added vitamin a and vitamin d"""	whole milk
"""kiwifruit, green, raw"""	kiwi
"""lettuce, cos or romaine, raw"""	romaine lettuce
"""seeds, pumpkin and squash seed kernels, dried"""	pumpkin seeds
"""lima beans, large, mature seeds, cooked, boiled, without salt"""	lima beans
"""beans, snap, yellow, frozen, cooked, boiled, drained, without salt"""	frozen whole green beans
"""collards, cooked, boiled, drained, without salt"""	steamed collard greens leaves and stalk
"""kale, cooked, boiled, drained, without salt"""	kale
"""pumpkin, cooked, boiled, drained, without salt"""	canned pumpkin
"""seeds, flaxseed"""	golden flaxseed
"""beef, round, eye of round, roast, separable lean only, trimmed to 1/8"""" fat, choice, raw"""	beef round tip steak
"""beans, snap, green, cooked, boiled, drained, without salt"""	steamed green beans
"""cherries, sour, red, canned, water pack, solids and liquids"""	whole sweet cherry
"""artichokes, (globe or french), cooked, boiled, drained, without salt"""	canned artichoke hearts
"""spinach, cooked, boiled, drained, without salt"""	frozen chopped spinach (green giant)
"""squash, winter, all varieties, cooked, baked, without salt"""	steamed butternut squash
"""wild rice, raw"""	enriched long white rice (mahatma)
"""kale, raw"""	kale
"""mushrooms, shiitake, cooked, without salt"""	steamed whole shiitake mushrooms
"""seaweed, kelp, raw"""	roasted seaweed
"""corn, sweet, white, frozen, kernels cut off cob, boiled, drained, without salt"""	frozen golden corn kernels (siganture select)
"""turkey, whole, neck, meat only, cooked, simmered"""	ground turkey
"""cowpeas (blackeyes), immature seeds, frozen, cooked, boiled, drained, without salt"""	black-eyed peas
"""sausage, meatless"""	beyond sausage
"""apricots, dried, sulfured, uncooked"""	dried apricots
"""mango, dried, sweetened"""	dried philippines mango (mariani)
"""bulgur, dry"""	red whole grain bulgur
"""beverages, wine, non-alcoholic"""	cabernet sauvignon wine
"""chard, swiss, cooked, boiled, drained, without salt"""	steamed red chard leaves and stalk (cal-organic)
"""seaweed, agar, dried"""	roasted seaweed
"""beef, round, top round, separable lean and fat, trimmed to 1/8"""" fat, all grades, cooked, braised"""	beef round tip steak
"""cherries, sweet, canned, pitted, heavy syrup pack, solids and liquids"""	whole sweet cherry
"""pumpkin, canned, without salt"""	canned pumpkin
"""sour cream, light"""	sour cream
"""beans, pinto, mature seeds, raw"""	canned low sodium pinto bean
"""papayas, raw"""	tai nung papaya
"""basil, fresh"""	basil
"""nuts, pine nuts, dried"""	pine nut
"""asparagus, canned, drained solids"""	frozen whole baby asparagus
"""beverages, abbott, eas soy protein powder"""	protein powder
"""dates, deglet noor"""	dates
"""okra, raw"""	frozen whole okra
"""chicken, broilers or fryers, breast, skinless, boneless, meat only, with added solution, raw"""	chicken breast
"""cowpeas (blackeyes), immature seeds, cooked, boiled, drained, without salt"""	black-eyed peas
"""beef, top sirloin, steak, separable lean only, trimmed to 1/8"""" fat, choice, cooked, broiled"""	beef round tip steak
"""beef, round, full cut, separable lean and fat, trimmed to 1/8"""" fat, choice, raw"""	beef round tip steak
"""cheese, pasteurized process, american, fortified with vitamin d"""	american cheese
"""peanuts, all types, oil-roasted, with salt"""	peanuts
"""chicken, broilers or fryers, meat only, stewed"""	chicken breast
"""beef, ground, 75% lean meat / 25% fat, loaf, cooked, baked"""	ground pork
"""marmalade, orange"""	orange jam (bonne maman)
"""broccoli, frozen, chopped, unprepared"""	frozen broccoli florets
"""cauliflower, frozen, unprepared"""	steamed cauliflower florets and stalk
"""corn, sweet, yellow, frozen, kernels cut off cob, unprepared"""	frozen golden corn kernels (siganture select)
"""peppers, sweet, red, frozen, chopped, unprepared"""	steamed whole red bell pepper w/o seed
"""wild rice, cooked"""	enriched long white rice (mahatma)
"""mangos, raw"""	yellow mango
"""beverages, abbott, eas whey protein powder"""	protein powder
"""yambean (jicama), raw"""	jicama
"""couscous, cooked"""	toasted pearl couscous
"""turkey, all classes, leg, meat and skin, cooked, roasted"""	ground turkey
"""mung beans, mature seeds, sprouted, cooked, boiled, drained, without salt"""	bean sprouts
"""eggplant, cooked, boiled, drained, without salt"""	eggplant
"""sweet potato, canned, vacuum pack"""	steamed whole sweet potato
"""turkey, whole, light meat, meat and skin, cooked, roasted"""	ground turkey
"""turkey from whole, light meat, meat and skin, with added solution, cooked, roasted"""	ground turkey
"""soup, chicken broth, canned, condensed"""	low sodium chicken broth
"""brussels sprouts, frozen, cooked, boiled, drained, without salt"""	steamed whole brussel sprouts
"""rice, white, long-grain, regular, cooked, enriched, with salt"""	enriched long white rice (mahatma)
"""rice noodles, cooked"""	stir fry rice noodle
"""peanuts, all types, oil-roasted, without salt"""	peanuts
"""chicken, broilers or fryers, light meat, meat only, cooked, stewed"""	chicken breast
"""eggplant, raw"""	eggplant
"""soy flour, full-fat, raw"""	soy flour
"""pork, cured, salt pork, raw"""	ground pork
"""limes, raw"""	lime juice
"""celery, cooked, boiled, drained, without salt"""	steamed celery stalk
"""butter, light, stick, with salt"""	unsalted butter
"""squash, summer, crookneck and straightneck, canned, drained, solid, without salt"""	steamed yellow neck squash
"""cheese spread, cream cheese base"""	cream cheese
"""sweet potato, raw, unprepared (includes foods for usda's food distribution program)"""	steamed whole sweet potato
"""beverages, protein powder soy based"""	protein powder
"""pork, fresh, ground, cooked"""	ground pork
"""bacon, meatless"""	plant based bacon strip
"""blueberries, frozen, sweetened"""	frozen whole blueberry
"""beverages, coffee, instant, regular, half the caffeine"""	brewed coffee
"""beef, flank, steak, separable lean only, trimmed to 0"""" fat, choice, raw"""	beef round tip steak
"""cheese, mozzarella, whole milk"""	low moisture part skim mozarella cheese
"""chicken, broilers or fryers, breast, meat only, cooked, roasted"""	chicken breast
"""wheat flour, white, all-purpose, unenriched"""	all purpose flour
"""beef, round, tip round, roast, separable lean and fat, trimmed to 1/8"""" fat, choice, cooked, roasted"""	beef round tip steak
"""rice, white, long-grain, regular, unenriched, cooked without salt"""	enriched long white rice (mahatma)
"""lime juice, canned or bottled, unsweetened"""	lime juice
"""lima beans, immature seeds, cooked, boiled, drained, without salt"""	lima beans
"""beef, round, tip round, roast, separable lean and fat, trimmed to 1/8"""" fat, select, cooked, roasted"""	beef round tip steak
"""blueberries, canned, heavy syrup, solids and liquids"""	whole blueberry
"""pomegranates, raw"""	pomegranate w/ seeds
"""turkey, drumstick, from whole bird, meat only, with added solution, roasted"""	ground turkey
"""turkey, drumstick, from whole bird, meat only, roasted"""	ground turkey
"""cocoa, dry powder, hi-fat or breakfast, processed with alkali"""	cocoa powder
"""sour cream, reduced fat"""	sour cream
"""bulgur, cooked"""	red whole grain bulgur
soy protein isolate	protein powder
"""cherries, sweet, canned, water pack, solids and liquids"""	whole sweet cherry
"""turkey, light or dark meat, smoked, cooked, skin and bone removed"""	ground turkey
"""turkey, light or dark meat, smoked, cooked, with skin, bone removed"""	ground turkey
"""asparagus, cooked, boiled, drained"""	frozen whole baby asparagus
"""artichokes, (globe or french), frozen, cooked, boiled, drained, without salt"""	canned artichoke hearts
"""asparagus, frozen, cooked, boiled, drained, without salt"""	frozen whole baby asparagus
"""squash, winter, spaghetti, cooked, boiled, drained, or baked, without salt"""	steamed spaghetti squash
"""beef, round, tip round, roast, separable lean and fat, trimmed to 1/8"""" fat, all grades, cooked, roasted"""	beef round tip steak
"""seaweed, spirulina, dried"""	roasted seaweed
"""cheese, pasteurized process, cheddar or american, low sodium"""	american cheese
"""grapefruit, sections, canned, light syrup pack, solids and liquids"""	deep red grapefruit
"""milk, reduced fat, fluid, 2% milkfat, without added vitamin a and vitamin d"""	whole milk
"""egg, whole, cooked, fried"""	brown egg yolk
"""turkey, whole, dark meat, cooked, roasted"""	ground turkey
"""arugula, raw"""	arugula
"""beans, kidney, all types, mature seeds, cooked, boiled, without salt"""	canned kidney beans
"""milk, whole, 3.25% milkfat, without added vitamin a and vitamin d"""	whole milk
"""apricots, dried, sulfured, stewed, without added sugar"""	dried apricots
"""chicken, cornish game hens, meat only, cooked, roasted"""	chicken breast
"""chard, swiss, raw"""	steamed red chard leaves and stalk (cal-organic)
"""turkey, whole, wing, meat only, cooked, roasted"""	ground turkey
"""cherries, sweet, canned, juice pack, solids and liquids"""	whole sweet cherry
"""turkey, wing, smoked, cooked, with skin, bone removed"""	ground turkey
"""snacks, popcorn, cakes"""	popcorn
"""turkey, whole, meat and skin, cooked, roasted"""	ground turkey
"""turkey, whole, meat and skin, with added solution, roasted"""	ground turkey
"""beans, black, mature seeds, raw"""	canned black beans (s&w)
"""turkey, whole, giblets, cooked, simmered"""	ground turkey
"""mustard greens, cooked, boiled, drained, without salt"""	steamed curely mustard greens
"""cauliflower, green, cooked, no salt added"""	steamed cauliflower florets and stalk
"""peanuts, all types, cooked, boiled, with salt"""	peanuts
"""tangerines, (mandarin oranges), canned, juice pack, drained"""	pixie tangerine
"""cherries, sour, red, frozen, unsweetened"""	whole sweet cherry
"""brussels sprouts, cooked, boiled, drained, without salt"""	steamed whole brussel sprouts
"""nuts, almond butter, plain, with salt added"""	almond butter (justin's)
"""grapefruit, raw, pink and red and white, all areas"""	deep red grapefruit
"""turkey, dark meat from whole, meat and skin, with added solution, cooked, roasted"""	ground turkey
"""kale, frozen, cooked, boiled, drained, without salt"""	kale
"""cheese, low-sodium, cheddar or colby"""	sharp chedder cheese
"""beverages, protein powder whey based"""	protein powder
"""pie fillings, blueberry, canned"""	whole blueberry
"""cabbage, red, cooked, boiled, drained, without salt"""	purple cabbage
"""buckwheat groats, roasted, cooked"""	hot cereal whole grain creamy buckwheat
"""blackberries, frozen, unsweetened"""	whole blackberry
"""cheese, mozzarella, nonfat"""	low moisture part skim mozarella cheese
"""nuts, almonds, oil roasted, without salt added"""	roasted almonds
"""plantains, cooked"""	plantain banana (steamed 10 in)
"""soymilk (all flavors), nonfat, with added calcium, vitamins a and d"""	soy milk
"""egg, whole, cooked, scrambled"""	brown egg yolk
"""protein supplement, milk based, muscle milk, powder"""	protein powder
"""tomatoes, red, ripe, canned, packed in tomato juice, no salt added"""	muir's diced tomatoes
"""turkey, back, from whole bird, meat and skin, with added solution, roasted"""	ground turkey
"""turkey, retail parts, thigh, meat and skin, cooked, roasted"""	ground turkey
"""protein supplement, milk based, muscle milk light, powder"""	protein powder
"""refried beans, canned, fat-free"""	refried beans
"""turkey, whole, dark meat, meat and skin, cooked, roasted"""	ground turkey
"""turkey, drumstick, smoked, cooked, with skin, bone removed"""	ground turkey
"""cheese, mozzarella, part skim milk"""	low moisture part skim mozarella cheese
"""turkey, whole, meat and skin, raw"""	ground turkey
"""turkey, retail parts, breast, meat and skin, with added solution, raw"""	chicken breast
"""beans, mature, red kidney, canned, solids and liquid, low sodium"""	canned kidney beans
"""nuts, cashew butter, plain, with salt added"""	cashew
"""cheese, american, nonfat or fat free"""	american cheese
"""cherries, tart, dried, sweetened (includes foods for usda's food distribution program)"""	whole sweet cherry
"""lentils, raw"""	whole grain brown lentils
"""quinoa, cooked"""	quinoa
"""cheese, pasteurized process, american, low fat"""	american cheese
"""babyfood, fruit, applesauce, strained"""	original apple sauce (tree top)
"""beans, black turtle, mature seeds, canned"""	canned black beans (s&w)
"""mushrooms, shiitake, dried"""	steamed whole shiitake mushrooms
"""cheese, mozzarella, low sodium"""	low moisture part skim mozarella cheese
"""beverages, tea, black, ready-to-drink, lemon, sweetened"""	black tea
"""beverages, tea, black, ready to drink"""	black tea
"""yogurt, greek, plain, lowfat"""	yogurt
"""yogurt, greek, plain, whole milk"""	yogurt
"""beverages, tea, black, ready to drink, decaffeinated"""	black tea
"""apple juice, canned or bottled, unsweetened, with added ascorbic acid, calcium, and potassium"""	apple juice
"""beverages, tea, black, ready-to-drink, lemon, diet"""	black tea
"""beans, pinto, mature seeds, canned, solids and liquids, low sodium"""	canned low sodium pinto bean
"""edamame, frozen, prepared"""	frozen edamame
"""beverages, tea, black, ready to drink, decaffeinated, diet"""	black tea
"""yogurt, greek, vanilla, lowfat"""	yogurt
"""beverages, cocoa mix, no sugar added, powder"""	cocoa powder
"""babyfood, cereal, barley, dry fortified"""	rice cereal (gerber)
"""refried beans, canned, traditional, reduced sodium"""	refried beans
"""cauliflower, green, raw"""	steamed cauliflower florets and stalk
"""blackberries, canned, heavy syrup, solids and liquids"""	whole blackberry
"""cherries, sweet, canned, light syrup pack, solids and liquids"""	whole sweet cherry
"""babyfood, cookies"""	chocolate chip cookies
"""egg, whole, cooked, poached"""	whole brown egg
"""chicken breast, deli, rotisserie seasoned, sliced, prepackaged"""	chicken breast
"""chickpeas (garbanzo beans, bengal gram), mature seeds, canned, solids and liquids, low sodium"""	canned garbanzo beans
"""babyfood, cereal, rice, dry fortified"""	rice cereal (gerber)
"""broccoli, frozen, spears, cooked, boiled, drained, without salt"""	frozen broccoli florets
"""reduced sodium: chicken breast, deli, rotisserie seasoned, sliced, prepackaged"""	chicken breast
"""pork sausage, link/patty, reduced fat, cooked, pan-fried"""	ground pork
"""apples, raw, without skin"""	whole golden del apple w/o seed
"""pork, cured, bacon, pre-sliced, cooked, pan-fried"""	plant based bacon strip
"""peppers, hot chili, red, raw"""	steamed whole red bell pepper w/o seed
"""beef, chuck, blade roast, separable lean only, trimmed to 0"""" fat, all grades, cooked, braised"""	beef round tip steak
"""corn flour, masa, unenriched, white"""	cornmeal
"""frankfurter, beef, unheated"""	plant based hot dog
"""pork, fresh, loin, top loin (chops), boneless, separable lean and fat, raw"""	ground pork
"""pork, fresh, shoulder, (boston butt), blade (steaks), separable lean and fat, raw"""	ground pork
"""pork, fresh, loin, top loin (chops), boneless, separable lean and fat, with added solution, raw"""	ground pork
"""pork, fresh, shoulder, (boston butt), blade (steaks), separable lean and fat,with added solution, raw"""	ground pork
"""carrots, raw"""	steamed whole carrots
"""potatoes, baked, flesh and skin, without salt"""	steamed whole russet potato
catsup	tomato ketchup
"""beans, white, mature seeds, cooked, boiled, without salt"""	navy beans
"""snacks, potato chips, plain, salted"""	vegetable chips
"""rice flour, white, unenriched"""	all purpose flour
"""pork, fresh, composite of trimmed retail cuts (leg, loin, shoulder), separable lean only, raw"""	ground pork
"""tomato products, canned, puree, without salt added"""	hunt's tomato paste
"""beef, short loin, top loin, steak, separable lean and fat, trimmed to 1/8"""" fat, choice, cooked, grilled"""	beef round tip steak
"""beef, rib eye steak, boneless, lip-on, separable lean only, trimmed to 1/8"""" fat, all grades, cooked, grilled"""	beef round tip steak
"""beef, rib eye steak, boneless, lip-on, separable lean and fat, trimmed to 1/8"""" fat, all grades, cooked, grilled"""	beef round tip steak
"""pork, cured, ham, boneless, regular (approximately 11% fat), roasted"""	ground pork
"""pork, cured, ham, boneless, extra lean and regular, roasted"""	ground pork
"""pork, cured, ham -- water added, whole, boneless, separable lean and fat, heated, roasted"""	ground pork
"""pork, cured, ham and water product, whole, boneless, separable lean and fat, heated, roasted"""	ground pork
"""pork, cured, ham with natural juices, whole, boneless, separable lean and fat, heated, roasted"""	ground pork
"""lettuce, green leaf, raw"""	steamed iceberg lettuce
"""cereals, oats, regular and quick, not fortified, dry"""	rolled oats
"""oranges, raw, all commercial varieties"""	navel orange
"""alcoholic beverage, wine, table, all"""	cabernet sauvignon wine
"""pasta, cooked, enriched, without added salt"""	whole wheat spaghetti
"""ham, sliced, pre-packaged, deli meat (96%fat free, water added)"""	none
"""pork sausage, link/patty, cooked, pan-fried"""	ground pork
"""sausage, turkey, breakfast links, mild, raw"""	beyond sausage
"""pork, cured, ham -- water added, whole, boneless, separable lean only, heated, roasted"""	ground pork
"""pickles, cucumber, dill or kosher dill"""	pickles
"""beverages, tea, black, brewed, prepared with tap water, decaffeinated"""	black tea
"""soymilk, original and vanilla, with added calcium, vitamins a and d"""	soy milk
"""pineapple, canned, juice pack, drained"""	gold (golden) pineapple
"""corn, sweet, yellow, raw"""	frozen golden corn kernels (siganture select)
"""potatoes, boiled, cooked in skin, flesh, without salt"""	steamed whole russet potato
"""nuts, coconut meat, dried (desiccated), sweetened, flaked, packaged"""	dried coconut strips
"""beans, baked, canned, plain or vegetarian"""	canned black beans (s&w)
"""wheat flour, white, bread, enriched"""	all purpose flour
"""apples, raw, with skin"""	whole golden del apple w/o seed
"""broccoli, raw"""	frozen broccoli florets
"""fish, tuna, light, canned in water, drained solids"""	albacore white tuna
"""chicken, broiler, rotisserie, bbq, thigh, meat only"""	chicken breast
"""pork, fresh, loin, top loin (chops), boneless, separable lean only, raw"""	ground pork
"""pork, fresh, loin, top loin (chops), boneless, separable lean only, with added solution, raw"""	ground pork
"""pork, fresh, variety meats and by-products, feet, cooked, simmered"""	ground pork
"""beef, rib, large end (ribs 6-9), separable lean and fat, trimmed to 1/8"""" fat, all grades, cooked, roasted"""	beef round tip steak
"""corn, sweet, yellow, cooked, boiled, drained, without salt"""	frozen golden corn kernels (siganture select)
"""onions, frozen, chopped, cooked, boiled, drained, without salt"""	onion
"""corn, sweet, white, cooked, boiled, drained, without salt"""	frozen golden corn kernels (siganture select)
"""cheese, colby"""	sharp chedder cheese
"""sausage, italian, pork, cooked"""	ground pork
"""apples, dried, sulfured, uncooked"""	freeze dried apple rings
"""peanut butter, smooth style, with salt (includes foods for usda's food distribution program)"""	peanut butter (laura scudder's)
"""seeds, sesame butter, tahini, from roasted and toasted kernels (most common type)"""	tahini spread (365 whole foods market)
"""bananas, raw"""	yellow banana flesh only
"""corn, sweet, yellow, canned, whole kernel, drained solids"""	frozen golden corn kernels (siganture select)
"""pork, fresh, spareribs, separable lean and fat, cooked, braised"""	ground pork
"""orange juice, frozen concentrate, unsweetened, undiluted"""	pulp free orange juice
"""beef, ground, patties, frozen, cooked, broiled"""	ground pork
"""carrots, canned, regular pack, drained solids"""	steamed whole carrots
"""cream, fluid, heavy whipping"""	half and half
"""beef, round, top round roast, boneless, separable lean only, trimmed to 0"""" fat, all grades, cooked, roasted"""	beef round tip steak
"""beef, round, top round roast, boneless, separable lean and fat, trimmed to 0"""" fat, all grades, cooked, roasted"""	beef round tip steak
"""onions, spring or scallions (includes tops and bulb), raw"""	green onion
"""potatoes, flesh and skin, raw"""	steamed whole russet potato
"""pumpkin, raw"""	canned pumpkin
"""beef, chuck, arm pot roast, separable lean only, trimmed to 1/8"""" fat, choice, raw"""	beef round tip steak
"""cereals, corn grits, white, regular and quick, enriched, dry"""	dried corn grits/polenta
"""beans, snap, green, canned, regular pack, drained solids"""	steamed green beans
"""alcoholic beverage, wine, table, red"""	cabernet sauvignon wine
"""rice, brown, long-grain, cooked"""	brown rice (mahatma)
"""pork, fresh, loin, whole, separable lean only, cooked, roasted"""	ground pork
"""alcoholic beverage, beer, regular, all"""	budweiser
"""pickles, cucumber, sour, low sodium"""	pickles
"""sausage, breakfast sausage, beef, pre-cooked, unprepared"""	none
"""applesauce, canned, unsweetened, without added ascorbic acid (includes usda commodity)"""	original apple sauce (tree top)
"""pork, fresh, loin, center rib (chops), bone-in, separable lean only, cooked, braised"""	ground pork
"""peas, green, frozen, cooked, boiled, drained, without salt"""	frozen whole sweet green peas (flav r pac)
"""fish, tuna, fresh, yellowfin, raw"""	albacore white tuna
"""beverages, tea, instant, decaffeinated, unsweetened"""	black tea
"""peaches, canned, water pack, solids and liquids"""	whole yellow peach (prima farms)
"""soup, stock, chicken, home-prepared"""	low sodium chicken broth
"""pasta, dry, enriched"""	whole wheat spaghetti
"""beverages, tea, instant, lemon, unsweetened"""	black tea
"""plantains, yellow, raw"""	plantain banana (steamed 10 in)
"""pork, fresh, shoulder, (boston butt), blade (steaks), separable lean only, cooked, braised"""	ground pork
"""potatoes, hash brown, frozen, plain, prepared, pan fried in canola oil"""	steamed whole russet potato
"""beef, cured, corned beef, brisket, cooked"""	none
"""pie fillings, apple, canned"""	original apple sauce (tree top)
"""apple juice, frozen concentrate, unsweetened, undiluted, without added ascorbic acid"""	apple juice
"""pork, cured, ham, whole, separable lean only, roasted"""	ground pork
"""pork, cured, ham, extra lean and regular, canned, roasted"""	ground pork
"""pork, cured, ham, shank, bone-in, separable lean and fat, heated, roasted"""	ground pork
"""pork, fresh, shoulder, arm picnic, separable lean and fat, cooked, braised"""	ground pork
"""pears, canned, water pack, solids and liquids"""	whole bartlett pear flesh only
"""pickles, cucumber, sour"""	pickles
"""beans, snap, green, canned, no salt added, drained solids"""	steamed green beans
"""potato puffs, frozen, unprepared"""	none
"""peas, green, raw"""	frozen whole sweet green peas (flav r pac)
"""breakfast bar, corn flake crust with fruit"""	snack bar (blueberry)
"""nuts, coconut meat, raw"""	dried coconut strips
"""pork, cured, ham and water product, whole, boneless, separable lean only, heated, roasted"""	ground pork
"""pork, cured, ham with natural juices, whole, boneless, separable lean only, heated, roasted"""	ground pork
"""cabbage, chinese (pak-choi), raw"""	steamed baby bok choy leaves and stalk
"""plums, dried (prunes), uncooked"""	unsweetened pitted prunes
"""broccoli, cooked, boiled, drained, without salt"""	steamed crown broccoli florets and stalk
"""orange juice, frozen concentrate, unsweetened, undiluted, with added calcium"""	pulp free orange juice
"""turkey breast, sliced, prepackaged"""	none
"""beets, canned, no salt added, solids and liquids"""	"""peeled, steamed beetroot"""
"""beef, chuck, arm pot roast, separable lean only, trimmed to 1/8"""" fat, all grades, cooked, braised"""	beef round tip steak
"""beef, chuck, arm pot roast, separable lean and fat, trimmed to 1/8"""" fat, all grades, cooked, braised"""	beef round tip steak
"""pork, fresh, composite of trimmed retail cuts (leg, loin, and shoulder), separable lean only, cooked"""	ground pork
"""roast beef, deli style, prepackaged, sliced"""	none
"""cream, fluid, light (coffee cream or table cream)"""	half and half
"""buckwheat flour, whole-groat"""	hot cereal whole grain creamy buckwheat
"""corn flour, masa, enriched, white"""	cornmeal
"""peppers, hot chili, green, raw"""	steamed whole green bell pepper w/o seed
"""beef, ground, 85% lean meat / 15% fat, raw (includes foods for usda's food distribution program)"""	ground pork
"""beef, rib, shortribs, separable lean only, choice, cooked, braised"""	beef round tip steak
"""pork, cured, ham, boneless, extra lean and regular, unheated"""	ground pork
"""beets, pickled, canned, solids and liquids"""	"""peeled, steamed beetroot"""
"""beverages, tea, instant, decaffeinated, lemon, diet"""	black tea
"""peas, green, cooked, boiled, drained, without salt"""	frozen whole sweet green peas (flav r pac)
"""peas, green (includes baby and lesuer types), canned, drained solids, unprepared"""	frozen whole sweet green peas (flav r pac)
"""pork, fresh, shoulder, (boston butt), blade (steaks), separable lean only, raw"""	ground pork
"""pork, fresh, shoulder, (boston butt), blade (steaks), separable lean only, with added solution, raw"""	ground pork
"""mustard greens, frozen, cooked, boiled, drained, without salt"""	steamed curely mustard greens
"""peas, green, canned, no salt added, solids and liquids"""	frozen whole sweet green peas (flav r pac)
"""beef, cured, corned beef, canned"""	none
"""beverages, tea, instant, lemon, diet"""	black tea
"""pasta, whole-wheat, cooked (includes foods for usda's food distribution program)"""	whole wheat spaghetti
"""peas, edible-podded, raw"""	whole snow peas
"""nuts, almond paste"""	almond butter (justin's)
"""tomatoes, red, ripe, cooked"""	muir's diced tomatoes
"""soup, vegetable with beef broth, canned, prepared with equal volume water"""	chunky vegetable soup
"""pork, fresh, loin, whole, separable lean only, cooked, braised"""	ground pork
"""broccoli, chinese, raw"""	frozen broccoli florets
"""beef, chuck, arm pot roast, separable lean and fat, trimmed to 1/8"""" fat, choice, cooked, braised"""	beef round tip steak
"""beef, chuck, arm pot roast, separable lean only, trimmed to 1/8"""" fat, choice, cooked, braised"""	beef round tip steak
"""pork, fresh, loin, tenderloin, separable lean and fat, raw"""	ground pork
"""pork, fresh, loin, tenderloin, separable lean and fat, with added solution, raw"""	ground pork
"""kielbasa, fully cooked, grilled"""	beyond sausage
"""potatoes, baked, skin, without salt"""	steamed whole russet potato
"""beets, canned, drained solids"""	"""peeled, steamed beetroot"""
"""milk, imitation, non-soy"""	coconut milk
"""beef, round, bottom round , roast, separable lean only, trimmed to 1/8"""" fat, select, cooked, roasted"""	beef round tip steak
"""pork, cured, bacon, unprepared"""	plant based bacon strip
"""beef, cured, pastrami"""	none
"""beef, brisket, whole, separable lean only, trimmed to 0"""" fat, all grades, cooked, braised"""	beef round tip steak
"""beef, brisket, whole, separable lean and fat, trimmed to 0"""" fat, all grades, cooked, braised"""	beef round tip steak
"""pork, fresh, shoulder, whole, separable lean only, cooked, roasted"""	ground pork
"""corn, sweet, yellow, canned, no salt added, solids and liquids"""	frozen golden corn kernels (siganture select)
"""peas, edible-podded, boiled, drained, without salt"""	steamed whole snow peas
"""collards, frozen, chopped, cooked, boiled, drained, without salt"""	steamed collard greens leaves and stalk
"""apples, dried, sulfured, stewed, without added sugar"""	freeze dried apple rings
"""ice creams, chocolate, rich"""	vanilla bean ice cream
"""whey, sweet, dried"""	protein powder
"""pork, cured, ham, center slice, country-style, separable lean only, raw"""	ground pork
"""carrots, frozen, unprepared"""	steamed whole carrots
"""peas, green, frozen, unprepared"""	frozen whole sweet green peas (flav r pac)
"""canadian bacon, cooked, pan-fried"""	plant based bacon strip
"""beef, cured, dried"""	none
"""beverages, tea, instant, unsweetened, powder"""	black tea
"""pork, fresh, loin, whole, separable lean only, raw"""	ground pork
"""apples, raw, without skin, cooked, microwave"""	freeze dried apple rings
"""turkey, whole, breast, meat only, cooked, roasted"""	chicken breast
"""tomatoes, red, ripe, canned, stewed"""	muir's diced tomatoes
"""pork, fresh, shoulder, arm picnic, separable lean only, cooked, braised"""	ground pork
"""pork, cured, shoulder, arm picnic, separable lean only, roasted"""	ground pork
"""peppers, hot chili, red, canned, excluding seeds, solids and liquids"""	steamed whole red bell pepper w/o seed
"""cheese, brick"""	sharp chedder cheese
"""rice, brown, long-grain, raw"""	brown rice (mahatma)
"""beef, rib, small end (ribs 10-12), separable lean only, trimmed to 1/8""""fat, choice, cooked, broiled"""	beef round tip steak
"""orange juice, canned, unsweetened"""	pulp free orange juice
"""beef, rib, shortribs, separable lean and fat, choice, cooked, braised"""	beef round tip steak
"""orange juice, frozen concentrate, unsweetened, diluted with 3 volume water"""	pulp free orange juice
"""beets, cooked, boiled, drained"""	"""peeled, steamed beetroot"""
"""carrots, canned, no salt added, solids and liquids"""	steamed whole carrots
"""pork, fresh, variety meats and by-products, chitterlings, cooked, simmered"""	ground pork
"""apricots, canned, light syrup pack, with skin, solids and liquids"""	dried apricots
"""pork, fresh, leg (ham), whole, separable lean and fat, cooked, roasted"""	ground pork
"""soymilk, chocolate, with added calcium, vitamins a and d"""	soy milk
"""beef, chuck for stew, separable lean and fat, all grades, cooked, braised"""	beef round tip steak
"""peas, edible-podded, frozen, cooked, boiled, drained, without salt"""	steamed whole snow peas
"""beans, snap, yellow, cooked, boiled, drained, without salt"""	steamed green beans
"""beef, rib, whole (ribs 6-12), separable lean and fat, trimmed to 1/8"""" fat, choice, cooked, roasted"""	beef round tip steak
"""pineapple, canned, juice pack, solids and liquids"""	gold (golden) pineapple
"""pork, fresh, loin, whole, separable lean and fat, cooked, roasted"""	ground pork
"""onions, frozen, whole, cooked, boiled, drained, without salt"""	onion
"""pork, fresh, loin, tenderloin, separable lean only, raw"""	ground pork
"""pork, fresh, enhanced, loin, tenderloin, separable lean only, raw"""	ground pork
"""pork, cured, ham, extra lean and regular, canned, unheated"""	ground pork
"""pork, cured, ham with natural juices, whole, boneless, separable lean and fat, unheated"""	ground pork
"""pork, cured, ham and water product, whole, boneless, separable lean and fat, unheated"""	ground pork
"""pork, cured, ham -- water added, whole, boneless, separable lean and fat, unheated"""	ground pork
"""apricots, canned, heavy syrup pack, with skin, solids and liquids"""	dried apricots
"""ham, sliced, regular (approximately 11% fat)"""	none
"""apricots, canned, juice pack, with skin, solids and liquids"""	whole apricot
"""pears, asian, raw"""	whole shingo pear w/o seed
vegetarian fillets	plant based fish fillet
"""beef, composite of trimmed retail cuts, separable lean only, trimmed to 0"""" fat, all grades, cooked"""	beef round tip steak
"""pork, fresh, loin, tenderloin, separable lean only, cooked, roasted"""	ground pork
"""cream, fluid, light whipping"""	half and half
"""whey, acid, dried"""	protein powder
"""pork, cured, shoulder, arm picnic, separable lean and fat, roasted"""	ground pork
"""pork, fresh, composite of trimmed retail cuts (leg, loin, shoulder, and spareribs), separable lean and fat, cooked"""	ground pork
"""apples, dehydrated (low moisture), sulfured, uncooked"""	freeze dried apple rings
"""tofu, fried"""	soft silken tofu
"""pork, fresh, leg (ham), whole, separable lean only, cooked, roasted"""	ground pork
"""beverages, coca-cola, powerade, lemon-lime flavored, ready-to-drink"""	coca cola
"""corn, sweet, white, canned, whole kernel, drained solids"""	frozen golden corn kernels (siganture select)
"""chicken, canned, no broth"""	albacore white tuna
"""turkey, fryer-roasters, meat and skin, cooked, roasted"""	ground turkey
"""pork, cured, bacon, cooked, broiled, pan-fried or roasted, reduced sodium"""	plant based bacon strip
"""beef, top sirloin, steak, separable lean only, trimmed to 1/8"""" fat, select, cooked, broiled"""	beef round tip steak
"""beef, top sirloin, steak, separable lean and fat, trimmed to 1/8"""" fat, choice, cooked, pan-fried"""	beef round tip steak
"""beef, chuck, arm pot roast, separable lean only, trimmed to 1/8"""" fat, select, raw"""	beef round tip steak
"""cabbage, chinese (pak-choi), cooked, boiled, drained, without salt"""	steamed baby bok choy leaves and stalk
"""chicken patty, frozen, cooked"""	none
"""apricots, canned, water pack, with skin, solids and liquids"""	whole apricot
"""beef, composite of trimmed retail cuts, separable lean and fat, trimmed to 1/8"""" fat, all grades, cooked"""	beef round tip steak
"""pork, cured, ham, whole, separable lean only, unheated"""	ground pork
"""pork, cured, ham and water product, whole, boneless, separable lean only, unheated"""	ground pork
"""pork, cured, ham -- water added, whole, boneless, separable lean only, unheated"""	ground pork
"""pork, cured, ham with natural juices, whole, boneless, separable lean only, unheated"""	ground pork
"""pork, fresh, shoulder, whole, separable lean and fat, raw"""	ground pork
"""pork, cured, ham, extra lean (approximately 4% fat), canned, unheated"""	ground pork
"""nuts, coconut meat, dried (desiccated), sweetened, shredded"""	dried coconut chips
"""catsup, low sodium"""	tomato ketchup
"""beans, snap, yellow, canned, regular pack, drained solids"""	steamed green beans
"""pork, fresh, shoulder, whole, separable lean and fat, cooked, roasted"""	ground pork
"""beef, chuck, blade roast, separable lean and fat, trimmed to 1/8"""" fat, all grades, cooked, braised"""	beef round tip steak
"""ham, chopped, not canned"""	ground pork
"""beans, baked, canned, no salt added"""	canned black beans (s&w)
"""beans, black, mature seeds, canned, low sodium"""	canned black beans (s&w)
"""babyfood, fortified cereal bar, fruit filling"""	snack bar (blueberry)
"""fish, tuna, light, canned in oil, drained solids"""	albacore white tuna
"""pork, fresh, spareribs, separable lean and fat, raw"""	ground pork
"""sausage, chicken or turkey, italian style,  lower sodium"""	beyond sausage
"""bacon, turkey, low sodium"""	plant based bacon strip
"""beverages, tea, ready-to-drink, lemon, diet"""	none
"""broccoli, chinese, cooked"""	steamed crown broccoli florets and stalk
"""beverages, tea, oolong, brewed"""	black tea
"""beverages, chocolate powder, no sugar added"""	cocoa powder
"""reduced sodium: turkey breast, sliced, prepackaged"""	ground turkey
"""potatoes, canned, drained solids, no salt added"""	steamed whole russet potato
"""cabbage, japanese style, fresh, pickled"""	purple cabbage
"""cheese, monterey"""	sharp chedder cheese
"""cream substitute, powdered"""	half and half
"""milk, lowfat, fluid, 1% milkfat, with added vitamin a and vitamin d"""	whole milk
"""milk, nonfat, fluid, with added vitamin a and vitamin d (fat free or skim)"""	whole milk
"""spices, cinnamon, ground"""	none
"""spices, paprika"""	basil
"""spices, pepper, black"""	none
"""spices, turmeric, ground"""	basil
"""salt, table, iodized"""	none
"""oil, soybean, salad or cooking"""	none
"""oil, olive, salad or cooking"""	none
"""oil, cottonseed, salad or cooking"""	none
"""oil, sunflower, linoleic, (approx. 65%)"""	sunflower seeds
"""oil, safflower, salad or cooking, high oleic (primary safflower oil of commerce)"""	none
"""oil, corn, industrial and retail, all purpose salad or cooking"""	none
"""oil, canola"""	none
"""margarine, regular, 80% fat, composite, stick, with salt"""	unsalted butter
"""margarine-like, vegetable oil spread, 60% fat, tub, with salt"""	unsalted butter
"""margarine, regular, 80% fat, composite, stick, with salt, with added vitamin d"""	unsalted butter
"""margarine-like, vegetable oil spread, 60% fat, tub, with salt, with added vitamin d"""	unsalted butter
"""potatoes, mashed, dehydrated, flakes without milk, dry form"""	steamed whole russet potato
"""alcoholic beverage, beer, light"""	budweiser
"""beverages, carbonated, ginger ale"""	sprite
"""water, tap, drinking"""	none
"""leavening agents, baking powder, double-acting, sodium aluminum sulfate"""	none
"""syrups, corn, light"""	maple syrup
"""noodles, egg, enriched, cooked"""	whole wheat spaghetti
"""chewing gum, sugarless"""	none
"""cream substitute, liquid, with hydrogenated vegetable oil and soy protein"""	half and half
"""spices, basil, dried"""	basil
"""spices, coriander leaf, dried"""	cilantro
"""spices, ginger, ground"""	none
"""spices, marjoram, dried"""	basil
"""spices, onion powder"""	garlic
"""spices, sage, ground"""	basil
"""vinegar, distilled"""	none
"""lemon juice, raw"""	lime juice
"""cassava, raw"""	none
potato flour	none
"""alcoholic beverage, distilled, all (gin, rum, vodka, whiskey) 80 proof"""	none
"""cheese, mexican, queso asadero"""	sharp chedder cheese
lard	unsalted butter
"""oil, peanut, salad or cooking"""	none
"""oil, sesame, salad or cooking"""	none
"""fat, turkey"""	ground turkey
"""turkey, skin from whole, (light and dark), with added solution, roasted"""	ground turkey
"""raisins, seedless"""	unsweetened pitted prunes
"""beverages, tea, instant, lemon, sweetened, powder"""	black tea
"""fat, chicken"""	none
"""grape juice, canned or bottled, unsweetened, with added ascorbic acid"""	none
"""soybeans, mature seeds, sprouted, cooked, steamed"""	bean sprouts
"""waterchestnuts, chinese, (matai), raw"""	none
"""sweeteners, tabletop, sucralose, splenda packets"""	none
"""sweeteners, tabletop, saccharin (sodium saccharin)"""	none
"""cheese, provolone"""	low moisture part skim mozarella cheese
"""cheese, swiss"""	sharp chedder cheese
"""spices, chili powder"""	basil
"""mustard, prepared, yellow"""	none
"""chicken, broilers or fryers, skin only, raw"""	none
"""beef, retail cuts, separable fat, cooked"""	none
"""beverages, lemonade fruit juice drink light, fortified with vitamin e and c"""	pulp free orange juice
"""vinegar, cider"""	none
"""oil, coconut"""	dried coconut strips
"""shortening, vegetable, household, composite"""	unsalted butter
"""chicken, broilers or fryers, dark meat, drumstick, meat only, cooked, roasted"""	none
"""tamarinds, raw"""	none
"""juice, apple and grape blend, with added ascorbic acid"""	apple juice
"""leavening agents, yeast, baker's, active dry"""	none
"""vanilla extract, imitation, no alcohol"""	vanilla bean ice cream
"""beverages, lemonade-flavor drink, powder"""	none
"""water, tap, municipal"""	none
"""fish, salmon, pink, raw"""	albacore white tuna
molasses	honey
"""ginger root, raw"""	none
"""fish, haddock, raw"""	albacore white tuna
"""noodles, egg, dry, enriched"""	whole brown egg
"""salad dressing, ranch dressing, regular"""	none
"""radishes, raw"""	none
"""fat, beef tallow"""	none
"""beverages, yellow green colored citrus soft drink with caffeine"""	sprite
"""beverages, carbonated, root beer"""	coca cola
"""cranberry juice, unsweetened"""	none
"""cheese, parmesan, grated"""	sharp chedder cheese
"""beverages, carbonated, low calorie, cola or pepper-type, with aspartame, without caffeine"""	coca cola
"""beverages, carbonated, low calorie, cola or pepper-type, with aspartame, contains caffeine"""	coca cola
"""milk, nonfat, fluid, without added vitamin a and vitamin d (fat free or skim)"""	whole milk
"""grape juice, canned or bottled, unsweetened, without added ascorbic acid"""	none
vitamin d as ingredient	none
"""cheese, blue"""	sharp chedder cheese
"""alcoholic beverage, wine, dessert, sweet"""	cabernet sauvignon wine
"""rye flour, medium"""	none
"""nopales, raw"""	none
"""beverages, chocolate-flavor beverage mix for milk, powder, with added nutrients"""	protein powder
"""milk, buttermilk, fluid, whole"""	whole milk
"""avocados, raw, all commercial varieties"""	none
"""crustaceans, crab, alaska king, imitation, made from surimi"""	shrimp
"""leavening agents, baking soda"""	none
"""spices, nutmeg, ground"""	none
"""grapefruit juice, white, canned or bottled, unsweetened"""	deep red grapefruit
"""tangerine juice, raw"""	pixie tangerine
"""fish, pollock, raw"""	albacore white tuna
"""fish, catfish, channel, farmed, raw"""	none
"""fish, tilapia, raw"""	albacore white tuna
"""cereals ready-to-eat, post, honey bunches of oats, honey roasted"""	honey nut oat cereal
"""cheese sauce, prepared from recipe"""	none
"""margarine,spread, 35-39% fat, tub"""	unsalted butter
"""margarine-like, vegetable oil spread, approximately 37% fat, unspecified oils, with salt, with added vitamin d"""	unsalted butter
"""chicken, broilers or fryers, giblets, cooked, simmered"""	none
"""apricot nectar, canned, with added ascorbic acid"""	whole apricot
"""boysenberries, frozen, unsweetened"""	whole blueberry
"""lemons, raw, without peel"""	none
"""passion-fruit juice, purple, raw"""	none
"""pineapple juice, canned or bottled, unsweetened, without added ascorbic acid"""	none
"""mango nectar, canned"""	none
"""babyfood, juice, pear"""	whole bartlett pear flesh only
"""beverages, slimfast, meal replacement,  high protein shake, ready-to-drink, 3-2-1 plan"""	protein powder
"""fish, flatfish (flounder and sole species), raw"""	none
"""sweeteners, tabletop, aspartame, equal, packets"""	none
"""tomatoes, green, raw"""	whole green house (large) tomato
"""beef, variety meats and by-products, tripe, raw"""	none
"""tomatillos, raw"""	none
"""hominy, canned, white"""	none
"""seeds, sesame seeds, whole, dried"""	sunflower seeds
"""lamb, composite of trimmed retail cuts, separable lean and fat, trimmed to 1/4"""" fat, choice, cooked"""	none
"""soup, beef broth or bouillon canned, ready-to-serve"""	low sodium chicken broth
"""whipped topping, frozen, low fat"""	vanilla bean ice cream
"""yogurt, plain, skim milk"""	yogurt
"""chicken, broilers or fryers, thigh, meat and skin, raw"""	none
"""tomato juice, canned, with salt added"""	vegetable juice
"""peppers, serrano, raw"""	steamed whole green bell pepper w/o seed
"""cheese, ricotta, part skim milk"""	cottage cheese
"""alcoholic beverage, malt beer, hard lemonade"""	budweiser
"""mollusks, clam, mixed species, canned, drained solids"""	albacore white tuna
"""beef, variety meats and by-products, liver, cooked, pan-fried"""	none
"""chicken, broilers or fryers, wing, meat and skin, cooked, roasted"""	chicken breast
"""beverages, tea, herb, other than chamomile, brewed"""	black tea
"""nuts, hazelnuts or filberts"""	hazelnut flour
"""leavening agents, yeast, baker's, compressed"""	none
"""chicken, broilers or fryers, drumstick, meat and skin, cooked, roasted"""	chicken breast
"""gravy, chicken, canned or bottled, ready-to-serve"""	low sodium chicken broth
"""salad dressing, italian dressing, fat-free"""	none
"""gravy, beef, canned, ready-to-serve"""	none
"""yogurt, frozen, flavors not chocolate, nonfat milk, with low-calorie sweetener"""	yogurt
"""spices, garlic powder"""	garlic
"""beverages, coconut water, ready-to-drink, unsweetened"""	coconut milk
"""fish, cod, pacific, raw (may have been previously frozen)"""	albacore white tuna
"""fish, sea bass, mixed species, raw"""	albacore white tuna
"""figs, dried, uncooked"""	dried apricots
"""waterchestnuts, chinese, canned, solids and liquids"""	none
"""fish, perch, mixed species, raw"""	albacore white tuna
"""olives, ripe, canned (small-extra large)"""	none
"""beverages, carbonated, tonic water"""	sprite
"""chicken, liver, all classes, raw"""	none
"""animal fat, bacon grease"""	unsalted butter
"""cheese, feta"""	none
"""yogurt, frozen, flavors other than chocolate, lowfat"""	yogurt
"""persimmons, japanese, raw"""	none
"""cheese, fresh, queso fresco"""	cottage cheese
"""fish, salmon, chinook, smoked"""	albacore white tuna
"""cabbage, savoy, raw"""	purple cabbage
"""soup, beef broth or bouillon, powder, dry"""	low sodium chicken broth
"""lemon peel, raw"""	none
"""cheese, ricotta, whole milk"""	cottage cheese
"""beverages, orange breakfast drink, ready-to-drink, with added nutrients"""	pulp free orange juice
"""oil, industrial, coconut, confection fat, typical basis for ice cream coatings"""	dried coconut chips
"""beverages, carbonated, low calorie, other than cola or pepper,  without caffeine"""	sprite
"""beverages, energy drink, red bull"""	none
"""spices, pepper, red or cayenne"""	none
"""horseradish, prepared"""	none
"""frozen yogurts, chocolate, nonfat milk, sweetened without sugar"""	yogurt
"""prune juice, canned"""	unsweetened pitted prunes
"""beverages, aloe vera juice drink, fortified with vitamin c"""	none
"""snacks, pork skins, plain"""	none
"""margarine-like, vegetable oil spread, fat-free, tub"""	unsalted butter
"""spices, thyme, dried"""	basil
"""crustaceans, crayfish, mixed species, wild, cooked, moist heat"""	shrimp
"""beverages, pepsico quaker, gatorade g2, low calorie"""	gatorade
"""beverages, cocoa mix, powder"""	cocoa powder
"""alcoholic beverage, liqueur, coffee with cream, 34 proof"""	none
"""fluid replacement, electrolyte solution (include pedialyte)"""	gatorade
"""cheese, mexican blend"""	sharp chedder cheese
"""lamb, loin, separable lean only, trimmed to 1/4"""" fat, choice, cooked, broiled"""	none
"""lamb, loin, separable lean and fat, trimmed to 1/4"""" fat, choice, cooked, broiled"""	none
"""spices, cumin seed"""	none
"""spices, oregano, dried"""	basil
"""oil, industrial, canola, high oleic"""	none
"""oil, industrial, soy, low linolenic"""	soy flour
"""oil, industrial, soy, ultra low linolenic"""	soy flour
"""oil, industrial, soy, fully hydrogenated"""	none
"""cream, whipped, cream topping, pressurized"""	half and half
"""snacks, beef jerky, chopped and formed"""	none
"""milk, buttermilk, fluid, cultured, reduced fat"""	buttermilk pancake/waffle flour
"""strawberry-flavor beverage mix, powder"""	none
"""beverages, unilever, slimfast, meal replacement, regular, ready-to-drink,  3-2-1 plan"""	protein powder
"""fish, ocean perch, atlantic, raw"""	albacore white tuna
"""fish, whiting, mixed species, raw"""	albacore white tuna
"""watercress, raw"""	arugula
orange pineapple juice blend	pulp free orange juice
"""veal, loin, separable lean and fat, raw"""	ground pork
"""beverages, ovaltine, chocolate malt powder"""	cocoa powder
"""margarine-like, vegetable oil spread, 20% fat, with salt"""	unsalted butter
"""milk, buttermilk, fluid, cultured, lowfat"""	whole milk
"""pimento, canned"""	none
"""beverages, orange-flavor drink, breakfast type, powder"""	pulp free orange juice
"""cheese, gruyere"""	sharp chedder cheese
"""bamboo shoots, raw"""	bean sprouts
"""noodles, flat, crunchy, chinese restaurant"""	stir fry rice noodle
"""beverages, rice milk, unsweetened"""	none
"""turnips, raw"""	none
"""mollusks, clam, mixed species, raw"""	none
"""fish, salmon, chum, canned, drained solids with bone"""	albacore white tuna
"""tapioca, pearl, dry"""	toasted pearl couscous
"""turnip greens, cooked, boiled, drained, without salt"""	steamed curely mustard greens
"""margarine-like, vegetable oil spread, fat free, liquid, with salt"""	none
"""pigeonpeas, immature seeds, cooked, boiled, drained, without salt"""	green split peas
"""crustaceans, crab, blue, cooked, moist heat"""	shrimp
"""mollusks, squid, mixed species, raw"""	none
"""cream, half and half, fat free"""	half and half
"""egg substitute, liquid or frozen, fat free"""	brown egg white
"""milk, buttermilk, dried"""	buttermilk pancake/waffle flour
"""spices, parsley, dried"""	parsley
"""oil, pam cooking spray, original"""	none
"""pineapple juice, canned or bottled, unsweetened, with added ascorbic acid"""	none
"""spices, cloves, ground"""	none
"""parmesan cheese topping, fat free"""	none
"""chicken, broilers or fryers, thigh, meat and skin, cooked, roasted"""	chicken breast
"""schiff,tiger's milk bar"""	protein powder
"""guavas, common, raw"""	none
"""lamb, ground, raw"""	ground pork
"""braunschweiger (a liver sausage), pork"""	ground pork
"""turnip greens, canned, no salt added"""	steamed collard greens leaves and stalk
"""cheese, swiss, low fat"""	low moisture part skim mozarella cheese
"""sauerkraut, canned, solids and liquids"""	none
"""margarine-like spread with yogurt, approximately 40% fat, tub, with salt"""	unsalted butter
"""veal, loin, separable lean only, cooked, roasted"""	none
"""fish, cod, atlantic, dried and salted"""	albacore white tuna
miso	soy sauce
"""alcoholic beverage, rice (sake)"""	cabernet sauvignon wine
"""pepper, banana, raw"""	yellow banana flesh only
"""veal, leg (top round), separable lean only, cooked, pan-fried, not breaded"""	beef round tip steak
"""cheese, brie"""	sharp chedder cheese
"""chicken, broilers or fryers, dark meat, drumstick, meat and skin, cooked, braised"""	none
"""fish, snapper, mixed species, raw"""	albacore white tuna
"""papaya nectar, canned"""	tai nung papaya
"""carbonated beverage, cream soda"""	coca cola
"""fish, cod, atlantic, canned, solids and liquid"""	albacore white tuna
"""beverages, the coca-cola company, minute maid, lemonade"""	coca cola
"""fish, croaker, atlantic, raw"""	albacore white tuna
"""fish, shark, mixed species, raw"""	albacore white tuna
"""chicken, broilers or fryers, dark meat, thigh, meat and skin, cooked, braised"""	none
"""spices, poultry seasoning"""	basil
"""guava sauce, cooked"""	original apple sauce (tree top)
"""lemon juice from concentrate, canned or bottled"""	lime juice
"""beverages, tea, green, brewed, decaffeinated"""	black tea
"""figs, raw"""	none
"""chicken, broilers or fryers, wing, meat and skin, cooked, stewed"""	chicken breast
"""turnip greens, frozen, cooked, boiled, drained, without salt"""	steamed curely mustard greens
"""beverage, instant breakfast powder, chocolate, not reconstituted"""	protein powder
"""pork, fresh, backfat, raw"""	ground pork
"""beans, pink, mature seeds, raw"""	canned kidney beans
"""fish, cod, atlantic, cooked, dry heat"""	albacore white tuna
"""mollusks, scallop, mixed species, raw"""	none
"""cheese, goat, semisoft type"""	none
"""pear nectar, canned, without added ascorbic acid"""	whole bartlett pear flesh only
"""alcoholic beverage, creme de menthe, 72 proof"""	cabernet sauvignon wine
"""beverages, carbonated, club soda"""	sprite
"""cheese, cottage, nonfat, uncreamed, dry, large or small curd"""	cottage cheese
"""cheese, cream, fat free"""	cream cheese
"""fish, trout, rainbow, farmed, raw"""	albacore white tuna
"""millet, puffed"""	none
"""crustaceans, lobster, northern, cooked, moist heat"""	shrimp
"""reduced sodium: ham, sliced, pre-packaged, deli meat (96%fat free, water added)"""	none
"""beverages, carbonated, low calorie, other than cola or pepper, with aspartame, contains caffeine"""	sprite
"""oil, flaxseed, cold pressed"""	golden flaxseed
"""frozen yogurts, chocolate"""	vanilla bean ice cream
"""radicchio, raw"""	none
"""olives, pickled, canned or bottled, green"""	pickles
"""cranberries, raw"""	cranberry
"""pears, dried, sulfured, uncooked"""	dried apricots
"""spices, curry powder"""	basil
"""lamb, shoulder, whole (arm and blade), separable lean and fat, trimmed to 1/4"""" fat, choice, cooked, roasted"""	none
"""lamb, shoulder, whole (arm and blade), separable lean only, trimmed to 1/4"""" fat, choice, cooked, roasted"""	none
"""fish, scup, raw"""	albacore white tuna
"""beverages, nestle, boost plus, nutritional drink, ready-to-drink"""	protein powder
"""beverages, abbott, ensure, nutritional shake, ready-to-drink"""	protein powder
"""chicken, broiler, rotisserie, bbq, wing, meat and skin"""	chicken breast
"""leeks, (bulb and lower leaf-portion), raw"""	green onion
"""beans, pink, mature seeds, cooked, boiled, without salt"""	canned low sodium pinto bean
"""cheese, muenster, low fat"""	none
"""soybeans, mature cooked, boiled, without salt"""	canned black beans (s&w)
"""snacks, plantain chips, salted"""	banana chips
"""turnips, frozen, cooked, boiled, drained, without salt"""	steamed whole russet potato
"""beef, variety meats and by-products, tongue, cooked, simmered"""	none
"""soybeans, mature seeds, roasted, salted"""	peanuts
"""game meat, deer, loin, separable lean only, 1"""" steak, cooked, broiled"""	beef round tip steak
"""salad dressing, thousand island dressing, fat-free"""	none
"""game meat, deer, shoulder clod, separable lean only, cooked, braised"""	none
"""noodles, chinese, chow mein"""	stir fry rice noodle
"""cheese, muenster"""	low moisture part skim mozarella cheese
"""mollusks, clam, mixed species, canned, liquid"""	albacore white tuna
"""oil, industrial, soy (partially hydrogenated), multiuse for non-dairy butter flavor"""	unsalted butter
"""mollusks, mussel, blue, raw"""	none
"""chicken, gizzard, all classes, cooked, simmered"""	none
"""milk, dry, nonfat, regular, without added vitamin a and vitamin d"""	protein powder
"""fish, cod, pacific, cooked, dry heat (may contain additives to retain moisture)"""	albacore white tuna
"""fish, salmon, pink, canned, total can contents"""	albacore white tuna
ham salad spread	none
"""malt beverage, includes non-alcoholic beer"""	budweiser
"""game meat, deer, ground, raw"""	ground pork
"""chicken, broilers or fryers, back, meat and skin, cooked, roasted"""	chicken breast
"""nopales, cooked, without salt"""	frozen whole okra
"""margarine, regular, 80% fat, composite, stick, without salt"""	unsalted butter
"""margarine, regular, 80% fat, composite, stick, without salt, with added vitamin d"""	unsalted butter
"""peaches, dried, sulfured, uncooked"""	dried apricots
"""margarine-like, margarine-butter blend, soybean oil and butter"""	unsalted butter
"""mung beans, mature seeds, cooked, boiled, without salt"""	whole grain brown lentils
"""fish, swordfish, raw"""	albacore white tuna
"""leavening agents, baking powder, double-acting, straight phosphate"""	none
"""beverages, propel zero, fruit-flavored, non-carbonated"""	gatorade
"""beverages, tea, herb, brewed, chamomile"""	black tea
"""crustaceans, crab, blue, canned"""	none
"""chicken, feet, boiled"""	none
"""frozen yogurts, flavors other than chocolate"""	vanilla bean ice cream
"""veal, sirloin, separable lean and fat, cooked, roasted"""	beef round tip steak
"""shortening industrial, soybean (hydrogenated) and cottonseed"""	none
"""oil, industrial, soy (partially hydrogenated)  and cottonseed, principal use as a tortilla shortening"""	none
"""sweeteners, tabletop, fructose, dry, powder"""	honey
"""rhubarb, raw"""	none
"""bamboo shoots, canned, drained solids"""	steamed whole snow peas
"""cheese, mexican, queso chihuahua"""	sharp chedder cheese
"""chayote, fruit, cooked, boiled, drained, without salt"""	steamed yellow neck squash
"""guava nectar, with sucralose, canned"""	none
"""milk, dry, nonfat, regular, with added vitamin a and vitamin d"""	protein powder
"""baking chocolate, unsweetened, squares"""	chocolate
"""cheese, mexican, queso anejo"""	sharp chedder cheese
"""onions, dehydrated flakes"""	onion
"""chicken, liver, all classes, cooked, simmered"""	none
"""chicken, cornish game hens, meat and skin, cooked, roasted"""	chicken breast
"""game meat, goat, cooked, roasted"""	ground pork
"""mollusks, oyster, eastern, wild, raw"""	none
"""chicken, broiler, rotisserie, bbq, thigh, meat and skin"""	chicken breast
"""milk, dry, whole, with added vitamin d"""	whole milk
"""spices, pumpkin pie spice"""	basil
"""fish, salmon, sockeye, canned, drained solids"""	albacore white tuna
"""beverages, abbott, ensure plus, ready-to-drink"""	none
"""egg, whole, dried"""	brown egg yolk
"""grapefruit juice, white, frozen concentrate, unsweetened, undiluted"""	deep red grapefruit
"""margarine-like vegetable-oil spread, stick/tub/bottle, 60% fat, with added vitamin d"""	unsalted butter
"""sour cream, fat free"""	sour cream
"""cereals ready-to-eat, wheat germ, toasted, plain"""	honey nut oat cereal
"""oil, almond"""	none
"""fish, mackerel, atlantic, raw"""	albacore white tuna
"""fish, mackerel, pacific and jack, mixed species, raw"""	albacore white tuna
"""milk, goat, fluid, with added vitamin d"""	whole milk
"""spices, celery seed"""	steamed celery stalk
"""duck, domesticated, meat and skin, cooked, roasted"""	none
"""chicken, broilers or fryers, neck, meat and skin, cooked simmered"""	none
"""cheese, gouda"""	sharp chedder cheese
"""crustaceans, crayfish, mixed species, wild, raw"""	shrimp
"""lamb, foreshank, separable lean and fat, trimmed to 1/4"""" fat, choice, cooked, braised"""	none
"""milk, dry, nonfat, instant, with added vitamin a and vitamin d"""	protein powder
"""crustaceans, lobster, northern, raw"""	shrimp
"""lamb, leg, whole (shank and sirloin), separable lean and fat, trimmed to 1/4"""" fat, choice, cooked, roasted"""	none
"""lamb, leg, whole (shank and sirloin), separable lean only, trimmed to 1/4"""" fat, choice, cooked, roasted"""	none
"""cheese, romano"""	sharp chedder cheese
"""oil, industrial, soy ( partially hydrogenated), all purpose"""	soy flour
"""leavening agents, cream of tartar"""	none
"""taro, cooked, without salt"""	steamed whole sweet potato
"""yam, cooked, boiled, drained, or baked, without salt"""	steamed whole sweet potato
"""rutabagas, raw"""	none
"""celeriac, raw"""	steamed celery stalk
"""fish, pompano, florida, raw"""	albacore white tuna
"""candies, confectioner's coating, yogurt"""	jolly rancher candy
"""margarine-like, vegetable oil spread, 60% fat, stick/tub/bottle, with salt"""	unsalted butter
"""chicken, broilers or fryers, separable fat, raw"""	none
"""babyfood, teething biscuits"""	honey graham crackers
"""fish, sardine, atlantic, canned in oil, drained solids with bone"""	albacore white tuna
"""nuts, coconut cream, canned, sweetened"""	coconut milk
"""seeds, sesame seed kernels, dried (decorticated)"""	sunflower seeds
"""cheese, cottage, lowfat, 1% milkfat"""	cottage cheese
"""alcoholic beverage, liqueur, coffee, 53 proof"""	brewed coffee
"""peach nectar, canned, with sucralose, without added ascorbic acid"""	none
"""turnips, cooked, boiled, drained, without salt"""	steamed whole russet potato
"""chicken, broilers or fryers, dark meat, meat only, cooked, roasted"""	chicken breast
"""nuts, chestnuts, european, roasted"""	pecan
"""sauce, horseradish"""	none
"""fish, herring, atlantic, raw"""	albacore white tuna
"""cheese, monterey, low fat"""	low moisture part skim mozarella cheese
"""spices, caraway seed"""	basil
"""game meat, bison, separable lean only, cooked, roasted"""	beef round tip steak
"""frog legs, raw"""	none
"""beverages, coffee substitute, cereal grain beverage, prepared with water"""	brewed coffee
"""fish, mackerel, jack, canned, drained solids"""	albacore white tuna
"""alcoholic beverage, wine, light"""	cabernet sauvignon wine
"""sweetener, herbal extract powder from stevia leaf"""	none
"""turtle, green, raw"""	none
"""lamb, ground, cooked, broiled"""	ground pork
"""game meat, deer, ground, cooked, pan-broiled"""	ground pork
"""grape leaves, raw"""	none
"""dandelion greens, cooked, boiled, drained, without salt"""	steamed curely mustard greens
"""milk, dry, whole, without added vitamin d"""	none
"""balsam-pear (bitter gourd), pods, cooked, boiled, drained, without salt"""	frozen whole okra
"""fish, mullet, striped, raw"""	albacore white tuna
"""capers, canned"""	none
"""margarine, regular, 80% fat, composite, tub, with salt"""	unsalted butter
"""margarine, regular, 80% fat, composite, tub, with salt, with added vitamin d"""	unsalted butter
"""veal, sirloin, separable lean and fat, raw"""	ground pork
"""pork, fresh, variety meats and by-products, stomach, raw"""	ground pork
"""candies, soft fruit and nut squares"""	jolly rancher candy
"""fish, herring, atlantic, pickled"""	albacore white tuna
"""pate, chicken liver, canned"""	none
"""chicken, broiler, rotisserie, bbq, breast, meat and skin"""	chicken breast
"""beef, variety meats and by-products, liver, cooked, braised"""	none
"""blackberry juice, canned"""	whole blackberry
"""rutabagas, cooked, boiled, drained, without salt"""	steamed butternut squash
"""alcoholic beverage, distilled, rum, 80 proof"""	budweiser
"""fish, carp, raw"""	albacore white tuna
"""taro, raw"""	none
"""oil, soybean, salad or cooking, (partially hydrogenated) and cottonseed"""	none
"""fish, roe, mixed species, raw"""	brown egg yolk
"""gravy, turkey, canned, ready-to-serve"""	none
"""mollusks, oyster, eastern, canned"""	albacore white tuna
"""cheese, parmesan, hard"""	sharp chedder cheese
"""oil, soybean, salad or cooking, (partially hydrogenated)"""	none
"""babyfood, fruit, apple and raspberry, strained"""	original apple sauce (tree top)
"""beverages, coffee, instant, mocha, sweetened"""	brewed coffee
"""whipped cream substitute, dietetic, made from powdered mix"""	none
"""lamb, cubed for stew or kabob (leg and shoulder), separable lean only, trimmed to 1/4"""" fat, cooked, braised"""	none
"""beverage, instant breakfast powder, chocolate, sugar-free, not reconstituted"""	protein powder
"""alcoholic beverage, wine, table, white"""	cabernet sauvignon wine
"""water, bottled, generic"""	none
"""escarole, cooked, boiled, drained, no salt added"""	steamed curely mustard greens
"""waxgourd, (chinese preserving melon), cooked, boiled, drained, without salt"""	steamed yellow neck squash
"""pork, fresh, separable fat, cooked"""	ground pork
"""water, non-carbonated, bottles, natural fruit flavors, sweetened with low calorie sweetener"""	sprite
"""beet greens, cooked, boiled, drained, without salt"""	steamed curely mustard greens
"""currants, zante, dried"""	none
"""grapefruit juice, white, raw"""	deep red grapefruit
"""game meat, rabbit, domesticated, composite of cuts, cooked, stewed"""	none
"""cream substitute, flavored, liquid"""	half and half
"""beverages, cytosport, muscle milk, ready-to-drink"""	protein powder
"""duck, domesticated, meat only, cooked, roasted"""	none
"""broadbeans (fava beans), mature seeds, cooked, boiled, without salt"""	canned black beans (s&w)
"""beef, variety meats and by-products, brain, cooked, simmered"""	none
"""chicken, broiler, rotisserie, bbq, drumstick, meat and skin"""	chicken breast
"""beverages, water with added vitamins and minerals, bottles, sweetened, assorted fruit flavors"""	gatorade
"""fish, halibut, atlantic and pacific, raw"""	albacore white tuna
"""parsnips, cooked, boiled, drained, without salt"""	steamed whole carrots
"""beverages, carbonated, reduced sugar, cola, contains caffeine and sweeteners"""	coca cola
"""veal, ground, cooked, broiled"""	ground pork
"""spices, mustard seed, ground"""	none
"""beverages, coffee substitute, cereal grain beverage, powder"""	brewed coffee
"""taro leaves, raw"""	steamed collard greens leaves and stalk
"""carbonated beverage, chocolate-flavored soda"""	coca cola
"""babyfood, apple-banana juice"""	apple juice
"""beef, variety meats and by-products, heart, cooked, simmered"""	none
"""quail, cooked, total edible"""	none
"""rhubarb, frozen, uncooked"""	none
"""game meat, boar, wild, cooked, roasted"""	ground pork
"""veal, leg (top round), separable lean and fat, cooked, braised"""	beef round tip steak
"""fish, eel, mixed species, raw"""	albacore white tuna
"""game meat, moose, cooked, roasted"""	none
"""radishes, oriental, cooked, boiled, drained, without salt"""	steamed whole carrots
"""fish, caviar, black and red, granular"""	none
"""burdock root, raw"""	"""peeled, steamed beetroot"""
"""game meat, raccoon, cooked, roasted"""	none
"""mollusks, snail, raw"""	none
"""cheese, camembert"""	sharp chedder cheese
"""yogurt, greek, plain, nonfat (includes foods for usda's food distribution program)"""	yogurt
"""milk dessert bar, frozen, made from lowfat milk"""	vanilla bean ice cream
"""mollusks, scallop, (bay and sea), cooked, steamed"""	none
"""soymilk, original and vanilla, light, with added calcium, vitamins a and d"""	soy milk
"""cheese, mexican, blend, reduced fat"""	low moisture part skim mozarella cheese
"""beverages, energy drink, vault, citrus flavor"""	none
"""cream substitute, powdered, light"""	half and half
"""cream substitute, liquid, light"""	half and half
"""beverages, orange juice, light, no pulp"""	pulp free orange juice
"""guanabana nectar, canned"""	none
"""beverages, the coca-cola company, hi-c flashin' fruit punch"""	coca cola
"""hearts of palm, raw"""	canned artichoke hearts
"""syrups, corn, high-fructose"""	none
"""cheese, swiss, low sodium"""	sharp chedder cheese
"""beverages, energy drink, rockstar"""	none
"""chicken, broilers or fryers, meat and skin and giblets and neck, roasted"""	chicken breast
"""cream substitute, flavored, powdered"""	protein powder
"""cheese, provolone, reduced fat"""	low moisture part skim mozarella cheese
"""beverages, energy drink, red bull, sugar free, with added caffeine, niacin, pantothenic acid, vitamins b6 and b12"""	none
"""beverages, energy drink, monster, fortified with vitamins c, b2, b3, b6, b12"""	none
"""beet greens, raw"""	steamed curely mustard greens
"""dandelion greens, raw"""	steamed curely mustard greens
natto	none
"""fennel, bulb, raw"""	none
"""game meat, bear, cooked, simmered"""	none
"""chicken, broilers or fryers, skin only, cooked, roasted"""	none
"""pomegranate juice, bottled"""	none
"""macaroni, vegetable, enriched, cooked"""	whole wheat spaghetti
"""beverages, energy drink, rockstar, sugar free"""	none
"""beverages, coffee, instant, with whitener, reduced calorie"""	brewed coffee
"""veal, composite of trimmed retail cuts, separable lean only, cooked"""	none
"""fish, pike, northern, raw"""	albacore white tuna
"""lotus root, cooked, boiled, drained, without salt"""	none
"""pokeberry shoots, (poke), cooked, boiled, drained, without salt"""	steamed curely mustard greens
"""cress, garden, raw"""	none
"""lamb, rib, separable lean and fat, trimmed to 1/4"""" fat, choice, cooked, broiled"""	none
"""lamb, rib, separable lean only, trimmed to 1/4"""" fat, choice, cooked, broiled"""	none
"""beverages, energy drink, amp"""	none
"""babyfood, fruit, bananas with tapioca, strained"""	yellow banana flesh only
"""babyfood, fruit, bananas with tapioca, junior"""	yellow banana flesh only
"""soymilk, chocolate and other flavors, light, with added calcium, vitamins a and d"""	soy milk
"""fish, sturgeon, mixed species, raw"""	albacore white tuna
"""beverages, energy drink, amp, sugar free"""	none
"""snacks, sweet potato chips, unsalted"""	vegetable chips
"""milk, fluid, nonfat, calcium fortified (fat free or skim)"""	whole milk
"""babyfood, water, bottled, gerber, without added fluoride"""	none
"""millet, cooked"""	brown rice (mahatma)
"""litchis, raw"""	none
"""babyfood, dessert, custard pudding, vanilla, strained"""	vanilla bean ice cream
"""babyfood, dessert, custard pudding, vanilla, junior"""	vanilla bean ice cream
"""beverages, powerade, zero, mixed berry"""	gatorade
"""candies, carob, unsweetened"""	none
"""beverages, tea, hibiscus, brewed"""	black tea
"""kohlrabi, raw"""	purple cabbage
"""pumpkin flowers, cooked, boiled, drained, without salt"""	steamed butternut squash
"""fish, herring, atlantic, kippered"""	albacore white tuna
"""veal, leg (top round), separable lean and fat, cooked, roasted"""	beef round tip steak
"""lamb, shoulder, whole (arm and blade), separable lean and fat, trimmed to 1/4"""" fat, choice, raw"""	ground pork
"""veal, composite of trimmed retail cuts, separable lean and fat, cooked"""	ground pork
"""kumquats, raw"""	pixie tangerine
"""potatoes, mashed, dehydrated, prepared from flakes without milk, whole milk and butter added"""	steamed whole russet potato
"""figs, dried, stewed"""	dried apricots
"""beverages, acai berry drink, fortified"""	none
"""snacks, peas, roasted, wasabi-flavored"""	frozen whole sweet green peas (flav r pac)
"""chayote, fruit, raw"""	steamed yellow neck squash
"""beverages, water, bottled, yumberry, pomegranate with anti-oxidants, zero calories"""	none
"""sweetener, syrup, agave"""	honey
"""pears, dried, sulfured, stewed, without added sugar"""	unsweetened pitted prunes
"""veal, leg (top round), separable lean and fat, cooked, pan-fried, breaded"""	none
"""veal, leg (top round), separable lean and fat, cooked, pan-fried, not breaded"""	beef round tip steak
"""beverages, unilever, slimfast shake mix, powder, 3-2-1 plan"""	protein powder
"""beverages, kellogg's, special k protein shake"""	protein powder
"""beverages, energy drink, sugar free"""	none
"""peanut flour, defatted"""	soy flour
"""cheese, cheddar, nonfat or fat free"""	sharp chedder cheese
"""cheese, swiss, nonfat or fat free"""	none
"""beverages, monster energy drink, low carb"""	none
"""beverages, the coca-cola company, nos energy drink, original, grape, loaded cherry, charged citrus, fortified with vitamins b6 and b12"""	coca cola
"""beef, variety meats and by-products, kidneys, cooked, simmered"""	none
"""game meat, beaver, cooked, roasted"""	none
"""beverages, unilever, slimfast shake mix, high protein, whey powder, 3-2-1 plan,"""	protein powder
"""balsam-pear (bitter gourd), leafy tips, cooked, boiled, drained, without salt"""	steamed baby bok choy leaves and stalk
"""broccoli raab, raw"""	none
"""loganberries, frozen"""	whole blackberry
"""sour cream, imitation, cultured"""	sour cream
"""blueberries, dried, sweetened"""	none
"""broccoli raab, cooked"""	steamed crown broccoli florets and stalk
"""babyfood, dessert, peach yogurt"""	yogurt
"""beverages, energy drink, vault zero, sugar-free, citrus flavor"""	none
"""babyfood, dinner, pasta with vegetables"""	whole wheat spaghetti
"""pork, cured, feet, pickled"""	ground pork
"""game meat, squirrel, cooked, roasted"""	none
"""duck, domesticated, meat only, raw"""	ground pork
"""yogurt, greek, strawberry, lowfat"""	yogurt
"""yogurt, greek, fruit, whole milk"""	yogurt
"""beverages, tea, green, brewed, regular"""	black tea
"""grapefruit juice, pink or red, with added calcium"""	deep red grapefruit
"""beverages, amber, hard cider"""	budweiser
"""grape juice, canned or bottled, unsweetened, with added ascorbic acid and calcium"""	none
"""alcoholic beverages, beer, higher alcohol"""	budweiser
"""egg, quail, whole, fresh, raw"""	brown egg yolk
"""yogurt, greek, strawberry, nonfat"""	yogurt
"""beverages, tea, green, ready to drink, unsweetened"""	none
"""alcoholic beverage, beer, light, higher alcohol"""	budweiser
"""fish, salmon, sockeye, raw"""	albacore white tuna
wasabi	none
"""beans, yellow, mature seeds, cooked, boiled, without salt"""	navy beans
"""yogurt, greek, vanilla, nonfat"""	yogurt
"""beverages, coffee, ready to drink, milk based, sweetened"""	none
"""beverages, the coca-cola company, glaceau vitamin water, revive fruit punch, fortified"""	coca cola
"""beverages, tea, green, ready-to-drink, sweetened"""	none
"""kefir, lowfat, plain, lifeway"""	yogurt
"""kefir, lowfat, strawberry, lifeway"""	yogurt
"""alcoholic beverage, beer, light, low carb"""	budweiser
"""beverages, tea, green, ready-to-drink, diet"""	none
"""beverages, malted drink mix, natural, powder, dairy based."""	protein powder
"""alcoholic beverages, wine, rose"""	cabernet sauvignon wine
"""succotash, (corn and limas), frozen, cooked, boiled, drained, without salt"""	lima beans
"""cheese, mexican, queso cotija"""	none
"""margarine-like, vegetable oil-butter spread, reduced calorie, tub, with salt"""	unsalted butter
"""mollusks, octopus, common, raw"""	none
"""beverages, apple juice drink, light, fortified with vitamin c"""	apple juice
"""beverages, kellogg's special k20 protein powder"""	protein powder
"""mollusks, abalone, mixed species, raw"""	none
"""beverages, powerade zero ion4, calorie-free, assorted flavors"""	gatorade
"""peaches, dried, sulfured, stewed, without added sugar"""	dried apricots
"""beverages, energy drink, full throttle"""	none
"""potatoes, mashed, home-prepared, whole milk added"""	steamed whole russet potato
"""dove, cooked (includes squab)"""	none
"""beverages,  energy drink, citrus"""	coca cola
"""cereals ready-to-eat, barbara's puffins, original"""	organic frosted flakes cereals
"""babyfood, grape juice, no sugar, canned"""	pulp free orange juice
"""child formula, abbott nutrition, pediasure, ready-to-feed"""	none
"""passion-fruit, (granadilla), purple, raw"""	none
"""noodles, egg, spinach, enriched, cooked"""	whole wheat spaghetti
"""sweet potato leaves, cooked, steamed, without salt"""	steamed collard greens leaves and stalk
"""chicken, broilers or fryers, back, meat and skin, cooked, stewed"""	chicken breast
"""beverages, ocean spray, cran-energy, cranberry energy juice drink"""	none
"""cheese, fontina"""	sharp chedder cheese
"""mollusks, octopus, common, cooked, moist heat"""	none
carob flour	hazelnut flour
"""radishes, hawaiian style, pickled"""	pickles
"""soup, beef broth, less/reduced sodium, ready to serve"""	low sodium chicken broth
